a	a
á	á
à	à
ả	ả
ạ	ạ
aaaaa	a a a a a
aarav	a a r a v
abc	a b c
abu	a b u
ác	á c
ặc	ặ c
aclanbêch	a c l a n b ê c h
ạcô	ạ c ô
acxanbêch	a c x a n b ê c h
adirondacks	a d i r o n d a c k s
adn	a d n
adventrapets	a d v e n t r a p e t s
ae	a e
aerospace	a e r o s p a c e
afp	a f p
ahai	a h a i
ai	a i
aỉ	a ỉ
aị	a ị
ái	á i
áị	á ị
ài	à i
aiz	a i z
ala	a l a
alo	a l o
alpha	a l p h a
altar	a l t a r
am	a m
ám	á m
âm	â m
ấm	ấ m
ầm	ầ m
ẩm	ẩ m
ậm	ậ m
ảm	ả m
america	a m e r i c a
ầmmmm	ầ m m m m
amột	a m ộ t
an	a n
án	á n
ăn	ă n
ân	â n
ấn	ấ n
ẩn	ẩ n
anăm	a n ă m
andersen	a n d e r s e n
áng	á n g
ắng	ắ n g
anh	a n h
ánh	á n h
ảnh	ả n h
anna	a n n a
ạnói	ạ n ó i
anto	a n t o
ao	a o
áo	á o
áọ	á ọ
ào	à o
àọ	à ọ
ảo	ả o
ảọ	ả ọ
áp	á p
ắp	ắ p
ấp	ấ p
ập	ậ p
arthur	a r t h u r
át	á t
ắt	ắ t
ất	ấ t
atám	a t á m
âu	â u
ấu	ấ u
ẩu	ẩ u
ấụ	ấ ụ
australia	a u s t r a l i a
australiachim	a u s t r a l i a c h i m
ay	a y
áy	á y
ây	â y
ấy	ấ y
ấỵ	ấ ỵ
azhar	a z h a r
b	b
ba	b a
bá	b á
bà	b à
bã	b ã
bả	b ả
bạ	b ạ
baa	b a a
bab	b a b
bác	b á c
bắc	b ắ c
bậc	b ậ c
bạc	b ạ c
bách	b á c h
bạch	b ạ c h
bah	b a h
bahba	b a h b a
bahkhông	b a h k h ô n g
bai	b a i
bái	b á i
bài	b à i
bãi	b ã i
bại	b ạ i
bạị	b ạ ị
balo	b a l o
bám	b á m
bặm	b ặ m
bấm	b ấ m
bầm	b ầ m
bẩm	b ẩ m
ban	b a n
bán	b á n
bàn	b à n
băn	b ă n
bắn	b ắ n
bân	b â n
bấn	b ấ n
bần	b ầ n
bẩn	b ẩ n
bận	b ậ n
bản	b ả n
bạn	b ạ n
bảncâu	b ả n c â u
banerdt	b a n e r d t
bang	b a n g
báng	b á n g
bàng	b à n g
băng	b ă n g
bằng	b ằ n g
bẵng	b ẵ n g
bảng	b ả n g
banh	b a n h
bánh	b á n h
bảnh	b ả n h
banteaymeanchey	b a n t e a y m e a n c h e y
bao	b a o
baọ	b a ọ
báo	b á o
bào	b à o
bão	b ã o
bãọ	b ã ọ
bảo	b ả o
bảỏ	b ả ỏ
bảọ	b ả ọ
bạo	b ạ o
bạọ	b ạ ọ
bắp	b ắ p
bấp	b ấ p
bập	b ậ p
bar	b a r
bát	b á t
bắt	b ắ t
bặt	b ặ t
bất	b ấ t
bật	b ậ t
bạt	b ạ t
báu	b á u
báụ	b á ụ
bấu	b ấ u
bầu	b ầ u
bay	b a y
baỵ	b a ỵ
bày	b à y
bây	b â y
bấy	b ấ y
bầy	b ầ y
bẫy	b ẫ y
bẩy	b ẩ y
bậy	b ậ y
bậỵ	b ậ ỵ
bảy	b ả y
bảyh	b ả y h
bé	b é
bè	b è
bê	b ê
bế	b ế
bề	b ề
bễ	b ễ
bể	b ể
bệ	b ệ
bẽ	b ẽ
bẻ	b ẻ
bệch	b ệ c h
ben	b e n
bén	b é n
bèn	b è n
bên	b ê n
bến	b ế n
bền	b ề n
bển	b ể n
bẽn	b ẽ n
béng	b é n g
bengal	b e n g a l
bênh	b ê n h
bềnh	b ề n h
bệnh	b ệ n h
béo	b é o
bèo	b è o
bẹo	b ẹ o
bếp	b ế p
bẹp	b ẹ p
bét	b é t
bết	b ế t
bi	b i
bí	b í
bì	b ì
bỉ	b ỉ
bị	b ị
bia	b i a
bìa	b ì a
bịa	b ị a
bích	b í c h
bịch	b ị c h
biếc	b i ế c
biên	b i ê n
biến	b i ế n
biển	b i ể n
biện	b i ệ n
biêng	b i ê n g
biếng	b i ế n g
biết	b i ế t
biệt	b i ệ t
biêu	b i ê u
biều	b i ề u
biểu	b i ể u
bìm	b ì m
bỉm	b ỉ m
binh	b i n h
bính	b í n h
bình	b ì n h
bỉnh	b ỉ n h
bịnh	b ị n h
bịp	b ị p
bịt	b ị t
bĩu	b ĩ u
bịu	b ị u
blog	b l o g
blogger	b l o g g e r
bo	b o
bó	b ó
bò	b ò
bô	b ô
bố	b ố
bồ	b ồ
bổ	b ổ
bộ	b ộ
bõ	b õ
bỏ	b ỏ
bọ	b ọ
bơ	b ơ
bớ	b ớ
bờ	b ờ
bỡ	b ỡ
bóc	b ó c
bốc	b ố c
bộc	b ộ c
bọc	b ọ c
bói	b ó i
bôi	b ô i
bối	b ố i
bồi	b ồ i
bội	b ộ i
bộị	b ộ ị
bơi	b ơ i
bới	b ớ i
bời	b ờ i
bởi	b ở i
bolt	b o l t
bom	b o m
bôm	b ô m
bơm	b ơ m
bờm	b ờ m
bôn	b ô n
bốn	b ố n
bồn	b ồ n
bổn	b ổ n
bộn	b ộ n
bọn	b ọ n
bỡn	b ỡ n
bonanza	b o n a n z a
bonanzan	b o n a n z a n
bốncm	b ố n c m
bong	b o n g
bóng	b ó n g
bòng	b ò n g
bông	b ô n g
bống	b ố n g
bồng	b ồ n g
bỗng	b ỗ n g
bổng	b ổ n g
bõng	b õ n g
bỏng	b ỏ n g
bọng	b ọ n g
bốnh	b ố n h
boong	b o o n g
booster	b o o s t e r
bóp	b ó p
bốp	b ố p
bộp	b ộ p
bot	b o t
bột	b ộ t
bọt	b ọ t
bớt	b ớ t
boy	b o y
brady	b r a d y
bruce	b r u c e
bù	b ù
búa	b ú a
bùa	b ù a
bừa	b ừ a
bữa	b ữ a
bục	b ụ c
bức	b ứ c
bực	b ự c
bùi	b ù i
bụi	b ụ i
bùm	b ù m
bùn	b ù n
bủn	b ủ n
búng	b ú n g
bùng	b ù n g
bụng	b ụ n g
bưng	b ư n g
bừng	b ừ n g
buộc	b u ộ c
bước	b ư ớ c
buổi	b u ổ i
buổị	b u ổ ị
buồm	b u ồ m
bươm	b ư ơ m
bướm	b ư ớ m
buôn	b u ô n
buồn	b u ồ n
buông	b u ô n g
buồng	b u ồ n g
bướng	b ư ớ n g
buốt	b u ố t
buột	b u ộ t
bụp	b ụ p
burmaadventurecat	b u r m a a d v e n t u r e c a t
bus	b u s
bút	b ú t
bứt	b ứ t
bưu	b ư u
bửu	b ử u
bvis	b v i s
bw	b
c	c
ca	c a
cá	c á
cà	c à
cả	c ả
các	c á c
cacao	c a c a o
cacbon	c a c b o n
cách	c á c h
cafe	c a f e
cai	c a i
cái	c á i
cáị	c á ị
cài	c à i
cãi	c ã i
cải	c ả i
california	c a l i f o r n i a
calypso	c a l y p s o
cam	c a m
cám	c á m
căm	c ă m
cắm	c ắ m
cằm	c ằ m
cặm	c ặ m
câm	c â m
cấm	c ấ m
cầm	c ầ m
cẩm	c ẩ m
cảm	c ả m
camen	c a m e n
camera	c a m e r a
camp	c a m p
campuchia	c a m p u c h i a
can	c a n
cán	c á n
càn	c à n
căn	c ă n
cắn	c ắ n
cằn	c ằ n
cặn	c ặ n
cân	c â n
cấn	c ấ n
cần	c ầ n
cẩn	c ẩ n
cận	c ậ n
cản	c ả n
cạn	c ạ n
canada	c a n a d a
cầnadskeeper	c ầ n a d s k e e p e r
cang	c a n g
càng	c à n g
căng	c ă n g
câng	c â n g
cảng	c ả n g
canh	c a n h
cánh	c á n h
cành	c à n h
cảnh	c ả n h
cạnh	c ạ n h
cao	c a o
caọ	c a ọ
cáo	c á o
cào	c à o
cạo	c ạ o
cáp	c á p
cắp	c ắ p
cặp	c ặ p
cấp	c ấ p
cập	c ậ p
carmera	c a r m e r a
carolina	c a r o l i n a
cát	c á t
cắt	c ắ t
cất	c ấ t
cats	c a t s
catwalk	c a t a l k
cau	c a u
cáu	c á u
càu	c à u
câu	c â u
cấu	c ấ u
cầu	c ầ u
cẩu	c ẩ u
cậu	c ậ u
câụ	c â ụ
cầụ	c ầ ụ
cay	c a y
cày	c à y
cây	c â y
cấy	c ấ y
cầy	c ầ y
cậy	c ậ y
câỵ	c â ỵ
cầỵ	c ầ ỵ
cạy	c ạ y
cba	c b a
ch	c h
cha	c h a
chà	c h à
chả	c h ả
chắc	c h ắ c
chậc	c h ậ c
chạch	c h ạ c h
chai	c h a i
chài	c h à i
chải	c h ả i
chăm	c h ă m
chằm	c h ằ m
châm	c h â m
chấm	c h ấ m
chầm	c h ầ m
chậm	c h ậ m
chạm	c h ạ m
chan	c h a n
chán	c h á n
chăn	c h ă n
chắn	c h ắ n
chẵn	c h ẵ n
chặn	c h ặ n
chân	c h â n
chấn	c h ấ n
chần	c h ầ n
chận	c h ậ n
chânem	c h â n e m
chang	c h a n g
chàng	c h à n g
chăng	c h ă n g
chẳng	c h ẳ n g
chặng	c h ặ n g
chánh	c h á n h
chao	c h a o
cháo	c h á o
chào	c h à o
chàọ	c h à ọ
chảo	c h ả o
chắp	c h ắ p
chấp	c h ấ p
chập	c h ậ p
character	c h a r a c t e r
charters	c h a r t e r s
chát	c h á t
chặt	c h ặ t
chất	c h ấ t
chật	c h ậ t
cháu	c h á u
châu	c h â u
chấu	c h ấ u
chầu	c h ầ u
chẩu	c h ẩ u
chậu	c h ậ u
châụ	c h â ụ
chay	c h a y
cháy	c h á y
chảy	c h ả y
chảỵ	c h ả ỵ
chạy	c h ạ y
chạỵ	c h ạ ỵ
che	c h e
ché	c h é
chè	c h è
chê	c h ê
chế	c h ế
chệ	c h ệ
chẽ	c h ẽ
check	c h e c k
cheftina	c h e f t i n a
chém	c h é m
chễm	c h ễ m
chen	c h e n
chén	c h é n
chẽn	c h ẽ n
cheo	c h e o
chéo	c h é o
chèo	c h è o
chèọ	c h è ọ
chép	c h é p
chết	c h ế t
chẹt	c h ẹ t
chi	c h i
chí	c h í
chì	c h ì
chỉ	c h ỉ
chị	c h ị
chia	c h i a
chìa	c h ì a
chĩa	c h ĩ a
chic	c h i c
chích	c h í c h
chiếc	c h i ế c
chiêm	c h i ê m
chiếm	c h i ế m
chiên	c h i ê n
chiến	c h i ế n
chiền	c h i ề n
chiêng	c h i ê n g
chiết	c h i ế t
chiêu	c h i ê u
chiếu	c h i ế u
chiều	c h i ề u
chiêụ	c h i ê ụ
chiềuem	c h i ề u e m
chim	c h i m
chím	c h í m
chìm	c h ì m
chín	c h í n
chinh	c h i n h
chính	c h í n h
chình	c h ì n h
chỉnh	c h ỉ n h
chínhba	c h í n h b a
chínx	c h í n x
chíu	c h í u
chịu	c h ị u
chịụ	c h ị ụ
cho	c h o
chó	c h ó
chỗ	c h ỗ
chọ	c h ọ
chớ	c h ớ
chờ	c h ờ
chở	c h ở
chợ	c h ợ
choang	c h o a n g
choáng	c h o á n g
choàng	c h o à n g
choắt	c h o ắ t
chóc	c h ó c
chốc	c h ố c
chọc	c h ọ c
chocolate	c h o c o l a t e
chói	c h ó i
chóị	c h ó ị
chối	c h ố i
chọi	c h ọ i
chơi	c h ơ i
chới	c h ớ i
chơỉ	c h ơ ỉ
chơị	c h ơ ị
chòm	c h ò m
chồm	c h ồ m
chộm	c h ộ m
chôn	c h ô n
chốn	c h ố n
chồn	c h ồ n
chọn	c h ọ n
chờn	c h ờ n
chong	c h o n g
chóng	c h ó n g
chống	c h ố n g
chồng	c h ồ n g
chỏng	c h ỏ n g
chóp	c h ó p
chộp	c h ộ p
chớp	c h ớ p
chợp	c h ợ p
chốt	c h ố t
chột	c h ộ t
chợt	c h ợ t
chu	c h u
chú	c h ú
chủ	c h ủ
chư	c h ư
chứ	c h ứ
chừ	c h ừ
chữ	c h ữ
chử	c h ử
chua	c h u a
chúa	c h ú a
chùa	c h ù a
chùạ	c h ù ạ
chưa	c h ư a
chứa	c h ứ a
chừa	c h ừ a
chữa	c h ữ a
chửa	c h ử a
chưả	c h ư ả
chưạ	c h ư ạ
chữạ	c h ữ ạ
chưaaaa	c h ư a a a a
chuẩn	c h u ẩ n
chúc	c h ú c
chục	c h ụ c
chức	c h ứ c
chui	c h u i
chùi	c h ù i
chửi	c h ử i
chum	c h u m
chúm	c h ú m
chùm	c h ù m
chung	c h u n g
chúng	c h ú n g
chùng	c h ù n g
chủng	c h ủ n g
chưng	c h ư n g
chứng	c h ứ n g
chừng	c h ừ n g
chững	c h ữ n g
chửng	c h ử n g
chuộc	c h u ộ c
chước	c h ư ớ c
chuối	c h u ố i
chuỗi	c h u ỗ i
chuông	c h u ô n g
chuồng	c h u ồ n g
chuộng	c h u ộ n g
chương	c h ư ơ n g
chướng	c h ư ớ n g
chưởng	c h ư ở n g
chuốt	c h u ố t
chuột	c h u ộ t
chụp	c h ụ p
chút	c h ú t
chụt	c h ụ t
chuỳ	c h u ỳ
chuyên	c h u y ê n
chuyến	c h u y ế n
chuyền	c h u y ề n
chuyển	c h u y ể n
chuyện	c h u y ệ n
cm	c m
cmn	c m n
co	c o
có	c ó
cò	c ò
cô	c ô
cố	c ố
cỗ	c ỗ
cổ	c ổ
cộ	c ộ
cỏ	c ỏ
cọ	c ọ
cơ	c ơ
cớ	c ớ
cờ	c ờ
cỡ	c ỡ
cóc	c ó c
cốc	c ố c
cộc	c ộ c
cọc	c ọ c
cờem	c ờ e m
coi	c o i
coị	c o ị
còi	c ò i
côi	c ô i
cối	c ố i
cội	c ộ i
cõi	c õ i
cõị	c õ ị
cỏi	c ỏ i
cỡi	c ỡ i
cởi	c ở i
cộm	c ộ m
cơm	c ơ m
combat	c o m b a t
con	c o n
còn	c ò n
côn	c ô n
cơn	c ơ n
cỡn	c ỡ n
cong	c o n g
còng	c ò n g
công	c ô n g
cổng	c ổ n g
cộng	c ộ n g
cõng	c õ n g
cờnói	c ờ n ó i
cooking	c o o k i n g
cộp	c ộ p
copernicus	c o p e r n i c u s
cốt	c ố t
cột	c ộ t
cợt	c ợ t
covid	c o v i d
croatia	c r o a t i a
croissant	c r o i s s a n t
cronus	c r o n u s
cu	c u
cú	c ú
cù	c ù
cũ	c ũ
củ	c ủ
cụ	c ụ
cư	c ư
cứ	c ứ
cử	c ử
cự	c ự
cua	c u a
của	c ủ a
cưa	c ư a
cửa	c ử a
cựa	c ự a
cửạ	c ử ạ
cựạ	c ự ạ
củayến	c ủ a y ế n
cuba	c u b a
cúc	c ú c
cục	c ụ c
cực	c ự c
cúi	c ú i
cùi	c ù i
cũi	c ũ i
củi	c ủ i
củị	c ủ ị
cụi	c ụ i
cụm	c ụ m
cún	c ú n
cung	c u n g
cúng	c ú n g
cùng	c ù n g
cũng	c ũ n g
củng	c ủ n g
cưng	c ư n g
cứng	c ứ n g
cuốc	c u ố c
cuộc	c u ộ c
cước	c ư ớ c
cược	c ư ợ c
cuối	c u ố i
cưới	c ư ớ i
cười	c ư ờ i
cưỡi	c ư ỡ i
cườị	c ư ờ ị
cuốn	c u ố n
cuồn	c u ồ n
cuộn	c u ộ n
cuống	c u ố n g
cuồng	c u ồ n g
cương	c ư ơ n g
cường	c ư ờ n g
cưỡng	c ư ỡ n g
cướp	c ư ớ p
cúp	c ú p
cụp	c ụ p
curie	c u r i e
cút	c ú t
cụt	c ụ t
cưu	c ư u
cứu	c ứ u
cừu	c ừ u
cửu	c ử u
cựu	c ự u
d	d
da	d a
dã	d ã
dạ	d ạ
đa	đ a
đá	đ á
đà	đ à
đã	đ ã
đả	đ ả
đạ	đ ạ
ðã	ã
đabi	đ a b i
dạc	d ạ c
đác	đ á c
đắc	đ ắ c
đặc	đ ặ c
đạc	đ ạ c
đạch	đ ạ c h
daday	d a d a y
dai	d a i
dài	d à i
dại	d ạ i
dạị	d ạ ị
đai	đ a i
đái	đ á i
đài	đ à i
đãi	đ ã i
đãị	đ ã ị
đại	đ ạ i
đạị	đ ạ ị
daikichi	d a i k i c h i
daily	d a i l y
daisuke	d a i s u k e
dam	d a m
dám	d á m
dăm	d ă m
dẵm	d ẵ m
dặm	d ặ m
dâm	d â m
dấm	d ấ m
dẫm	d ẫ m
dậm	d ậ m
đam	đ a m
đám	đ á m
đàm	đ à m
đăm	đ ă m
đắm	đ ắ m
đằm	đ ằ m
đâm	đ â m
đấm	đ ấ m
đầm	đ ầ m
đẫm	đ ẫ m
đậm	đ ậ m
đảm	đ ả m
đạm	đ ạ m
dan	d a n
dán	d á n
dàn	d à n
dằn	d ằ n
dặn	d ặ n
dân	d â n
dấn	d ấ n
dần	d ầ n
dẫn	d ẫ n
dẩn	d ẩ n
dạn	d ạ n
đan	đ a n
đán	đ á n
đàn	đ à n
đắn	đ ắ n
đẵn	đ ẵ n
đặn	đ ặ n
đần	đ ầ n
đẫn	đ ẫ n
đận	đ ậ n
đạn	đ ạ n
dang	d a n g
dáng	d á n g
dàng	d à n g
dằng	d ằ n g
dâng	d â n g
dạng	d ạ n g
đang	đ a n g
đáng	đ á n g
đàng	đ à n g
đăng	đ ă n g
đắng	đ ắ n g
đằng	đ ằ n g
đẳng	đ ẳ n g
đặng	đ ặ n g
đấng	đ ấ n g
đãng	đ ã n g
đảng	đ ả n g
danh	d a n h
dành	d à n h
đanh	đ a n h
đánh	đ á n h
đành	đ à n h
danielle	d a n i e l l e
dao	d a o
dào	d à o
dạo	d ạ o
đao	đ a o
đaọ	đ a ọ
đáo	đ á o
đáọ	đ á ọ
đào	đ à o
đàọ	đ à ọ
đảo	đ ả o
đảọ	đ ả ọ
đạo	đ ạ o
đạỏ	đ ạ ỏ
đạọ	đ ạ ọ
dấp	d ấ p
dập	d ậ p
đáp	đ á p
đắp	đ ắ p
đập	đ ậ p
đạp	đ ạ p
dát	d á t
dắt	d ắ t
dặt	d ặ t
dật	d ậ t
đắt	đ ắ t
đặt	đ ặ t
đất	đ ấ t
đật	đ ậ t
đạt	đ ạ t
dâu	d â u
dấu	d ấ u
dầu	d ầ u
dẫu	d ẫ u
dậu	d ậ u
đau	đ a u
đâu	đ â u
đấu	đ ấ u
đầu	đ ầ u
đẩu	đ ẩ u
đậu	đ ậ u
đâủ	đ â ủ
đâụ	đ â ụ
đấụ	đ ấ ụ
đầụ	đ ầ ụ
đậụ	đ ậ ụ
ðau	a u
đâuem	đ â u e m
đauuuuu	đ a u u u u u
day	d a y
dày	d à y
dây	d â y
dấy	d ấ y
dầy	d ầ y
dậy	d ậ y
dậỵ	d ậ ỵ
dãy	d ã y
dạy	d ạ y
dạỵ	d ạ ỵ
đáy	đ á y
đày	đ à y
đây	đ â y
đấy	đ ấ y
đầy	đ ầ y
đẩy	đ ẩ y
đậy	đ ậ y
đâỷ	đ â ỷ
đâỵ	đ â ỵ
đấỵ	đ ấ ỵ
đầỵ	đ ầ ỵ
đậỵ	đ ậ ỵ
đãy	đ ã y
dậyđánh	d ậ y đ á n h
đấyem	đ ấ y e m
đấyxong	đ ấ y x o n g
dcm	d c m
de	d e
dè	d è
dê	d ê
dễ	d ễ
đe	đ e
đè	đ è
đê	đ ê
đế	đ ế
đề	đ ề
để	đ ể
đệ	đ ệ
đẽ	đ ẽ
đẻ	đ ẻ
delta	d e l t a
dèm	d è m
đem	đ e m
đêm	đ ê m
đếm	đ ế m
đệm	đ ệ m
ðêm	ê m
đen	đ e n
đèn	đ è n
đến	đ ế n
đền	đ ề n
ðến	ế n
dẻo	d ẻ o
dẹo	d ẹ o
đeo	đ e o
đéo	đ é o
đèo	đ è o
đẽo	đ ẽ o
dép	d é p
dẹp	d ẹ p
đẹp	đ ẹ p
đẹpthằng	đ ẹ p t h ằ n g
dệt	d ệ t
đết	đ ế t
đều	đ ề u
đềụ	đ ề ụ
đh	đ h
di	d i
dí	d í
dì	d ì
dĩ	d ĩ
dị	d ị
đi	đ i
đị	đ ị
dĩa	d ĩ a
đìa	đ ì a
đĩa	đ ĩ a
địa	đ ị a
địạ	đ ị ạ
dịch	d ị c h
đích	đ í c h
địch	đ ị c h
điếc	đ i ế c
diêm	d i ê m
diễm	d i ễ m
diệm	d i ệ m
điem	đ i e m
điếm	đ i ế m
điềm	đ i ề m
điểm	đ i ể m
dien	d i e n
diễn	d i ễ n
diện	d i ệ n
điên	đ i ê n
điền	đ i ề n
điển	đ i ể n
điện	đ i ệ n
điếng	đ i ế n g
diệp	d i ệ p
điệp	đ i ệ p
diệt	d i ệ t
điệt	đ i ệ t
diêu	d i ê u
diều	d i ề u
diễu	d i ễ u
diệu	d i ệ u
diệụ	d i ệ ụ
điêu	đ i ê u
điếu	đ i ế u
điều	đ i ề u
điểu	đ i ể u
điệu	đ i ệ u
dim	d i m
dìm	d ì m
dinh	d i n h
dính	d í n h
đinh	đ i n h
đình	đ ì n h
đĩnh	đ ĩ n h
đỉnh	đ ỉ n h
định	đ ị n h
địnhđinh	đ ị n h đ i n h
dịp	d ị p
đít	đ í t
dìu	d ì u
dịu	d ị u
địu	đ ị u
dm	d m
đm	đ m
dn	d n
do	d o
dó	d ó
dò	d ò
dỗ	d ỗ
dọ	d ọ
dơ	d ơ
dỡ	d ỡ
dở	d ở
đo	đ o
đó	đ ó
đò	đ ò
đô	đ ô
đố	đ ố
đồ	đ ồ
đỗ	đ ỗ
đổ	đ ổ
độ	đ ộ
đõ	đ õ
đỏ	đ ỏ
đọ	đ ọ
đơ	đ ơ
đờ	đ ờ
đỡ	đ ỡ
doạ	d o ạ
đoá	đ o á
đoạ	đ o ạ
đoan	đ o a n
đoán	đ o á n
đoàn	đ o à n
đoản	đ o ả n
đoạn	đ o ạ n
đoang	đ o a n g
doanh	d o a n h
đoạt	đ o ạ t
dốc	d ố c
dọc	d ọ c
đốc	đ ố c
độc	đ ộ c
đọc	đ ọ c
dối	d ố i
dồi	d ồ i
dỗi	d ỗ i
dội	d ộ i
dộị	d ộ ị
dõi	d õ i
dõị	d õ ị
dơi	d ơ i
dời	d ờ i
đói	đ ó i
đóị	đ ó ị
đòi	đ ò i
đôi	đ ô i
đối	đ ố i
đồi	đ ồ i
đỗi	đ ỗ i
đổi	đ ổ i
đội	đ ộ i
đôị	đ ô ị
đốị	đ ố ị
đới	đ ớ i
đời	đ ờ i
đợi	đ ợ i
đờị	đ ờ ị
đợị	đ ợ ị
dòm	d ò m
dợm	d ợ m
đốm	đ ố m
đởm	đ ở m
dòn	d ò n
dồn	d ồ n
dọn	d ọ n
dỡn	d ỡ n
đón	đ ó n
đòn	đ ò n
đôn	đ ô n
đốn	đ ố n
đồn	đ ồ n
độn	đ ộ n
đơn	đ ơ n
đớn	đ ớ n
đờn	đ ờ n
donahue	d o n a h u e
donald	d o n a l d
dong	d o n g
dòng	d ò n g
dồng	d ồ n g
dõng	d õ n g
đong	đ o n g
đóng	đ ó n g
đông	đ ô n g
đống	đ ố n g
đồng	đ ồ n g
động	đ ộ n g
đọng	đ ọ n g
đồngnguyễn	đ ồ n g n g u y ễ n
dớp	d ớ p
đớp	đ ớ p
dốt	d ố t
đốt	đ ố t
đột	đ ộ t
đợt	đ ợ t
đpej	đ p e
drone	d r o n e
du	d u
dù	d ù
dụ	d ụ
dư	d ư
dứ	d ứ
dữ	d ữ
dự	d ự
đu	đ u
đủ	đ ủ
đừ	đ ừ
dua	d u a
dùa	d ù a
dụa	d ụ a
dưa	d ư a
dựa	d ự a
đua	đ u a
đùa	đ ù a
đũa	đ ũ a
đưa	đ ư a
đứa	đ ứ a
dục	d ụ c
dực	d ự c
đúc	đ ú c
đục	đ ụ c
đức	đ ứ c
đứcbộ	đ ứ c b ộ
đứcmàu	đ ứ c m à u
đứcnồi	đ ứ c n ồ i
duệ	d u ệ
dúi	d ú i
dùi	d ù i
dụi	d ụ i
đui	đ u i
đùi	đ ù i
đủi	đ ủ i
đùm	đ ù m
đun	đ u n
dung	d u n g
dùng	d ù n g
dũng	d ũ n g
dụng	d ụ n g
dưng	d ư n g
dừng	d ừ n g
dựng	d ự n g
đung	đ u n g
đúng	đ ú n g
đùng	đ ù n g
đũng	đ ũ n g
đụng	đ ụ n g
đứng	đ ứ n g
đừng	đ ừ n g
đựng	đ ự n g
duo	d u o
dược	d ư ợ c
đuốc	đ u ố c
đươc	đ ư ơ c
được	đ ư ợ c
ðược	ư ợ c
đượcđức	đ ư ợ c đ ứ c
duỗi	d u ỗ i
dưới	d ư ớ i
dướị	d ư ớ ị
đuôi	đ u ô i
đuối	đ u ố i
đuổi	đ u ổ i
đượm	đ ư ợ m
dương	d ư ơ n g
dường	d ư ờ n g
dưỡng	d ư ỡ n g
đương	đ ư ơ n g
đường	đ ư ờ n g
ðường	ư ờ n g
dượt	d ư ợ t
dứt	d ứ t
đút	đ ú t
đứt	đ ứ t
duy	d u y
duyên	d u y ê n
e	e
ê	ê
eames	e a m e s
ếch	ế c h
editor	e d i t o r
eika	e i k a
em	e m
êm	ê m
email	e m a i l
emem	e m e m
én	é n
enrique	e n r i q u e
eo	e o
éo	é o
ép	é p
ether	e t h e r
eton	e t o n
euro	e u r o
f	f
facebook	f a c e b o o k
family	f a m i l y
fanfic	f a n f i c
fanpage	f a n p a g e
fernie	f e r n i e
fhai	f h a i
fkhông	f k h ô n g
fmột	f m ộ t
forest	f o r e s t
frank	f r a n k
fuku	f u k u
fwb	f b
ga	g a
gà	g à
gã	g ã
gả	g ả
gạ	g ạ
gác	g á c
gạch	g ạ c h
gai	g a i
gái	g á i
gài	g à i
gãi	g ã i
gam	g a m
găm	g ă m
gắm	g ắ m
gằm	g ằ m
gặm	g ặ m
gâm	g â m
gấm	g ấ m
gầm	g ầ m
gẫm	g ẫ m
game	g a m e
gan	g a n
gán	g á n
gắn	g ắ n
gằn	g ằ n
gân	g â n
gần	g ầ n
gạn	g ạ n
gang	g a n g
gàng	g à n g
gắng	g ắ n g
gánh	g á n h
gáo	g á o
gào	g à o
gạo	g ạ o
gáp	g á p
găp	g ă p
gắp	g ắ p
gặp	g ặ p
gấp	g ấ p
gập	g ậ p
gas	g a s
gắt	g ắ t
gặt	g ặ t
gật	g ậ t
gạt	g ạ t
gấu	g ấ u
gẫu	g ẫ u
gay	g a y
gáy	g á y
gáỵ	g á ỵ
gây	g â y
gầy	g ầ y
gẫy	g ẫ y
gậy	g ậ y
gẫỵ	g ẫ ỵ
gãy	g ã y
gh	g h
ghe	g h e
ghé	g h é
ghè	g h è
ghê	g h ê
ghế	g h ế
ghen	g h e n
ghềnh	g h ề n h
ghẹo	g h ẹ o
ghẹọ	g h ẹ ọ
ghép	g h é p
ghét	g h é t
ghéttrước	g h é t t r ư ớ c
ghi	g h i
ghì	g h ì
ghim	g h i m
gì	g ì
gỉ	g ỉ
gia	g i a
giá	g i á
già	g i à
giã	g i ã
giả	g i ả
giạ	g i ạ
giác	g i á c
giặc	g i ặ c
giấc	g i ấ c
giadinhtsáu	g i a d i n h t s á u
giàhai	g i à h a i
giai	g i a i
giải	g i ả i
giảị	g i ả ị
giam	g i a m
giám	g i á m
giẫm	g i ẫ m
giảm	g i ả m
gian	g i a n
gián	g i á n
giàn	g i à n
giận	g i ậ n
giãn	g i ã n
giản	g i ả n
giang	g i a n g
giáng	g i á n g
giăng	g i ă n g
giằng	g i ằ n g
giảng	g i ả n g
giành	g i à n h
giao	g i a o
giaọ	g i a ọ
giáo	g i á o
giáỏ	g i á ỏ
giáọ	g i á ọ
giảo	g i ả o
giáp	g i á p
giát	g i á t
giặt	g i ặ t
giật	g i ậ t
giàu	g i à u
giấu	g i ấ u
giậu	g i ậ u
giày	g i à y
giây	g i â y
giấy	g i ấ y
giầy	g i ầ y
giãy	g i ã y
giếm	g i ế m
giếng	g i ế n g
gieo	g i e o
giết	g i ế t
giễu	g i ễ u
gin	g i n
gìn	g ì n
gió	g i ó
giò	g i ò
giỏ	g i ỏ
giơ	g i ơ
giờ	g i ờ
giở	g i ở
giỏi	g i ỏ i
giới	g i ớ i
giớị	g i ớ ị
giòn	g i ò n
giỡn	g i ỡ n
gióng	g i ó n g
giòng	g i ò n g
giông	g i ô n g
giống	g i ố n g
giọng	g i ọ n g
giọt	g i ọ t
giũ	g i ũ
giữ	g i ữ
giụa	g i ụ a
giữa	g i ữ a
giữạ	g i ữ ạ
giục	g i ụ c
giương	g i ư ơ n g
giường	g i ư ờ n g
giúp	g i ú p
giựt	g i ự t
go	g o
gò	g ò
gồ	g ồ
gỗ	g ỗ
gổ	g ổ
gõ	g õ
gỡ	g ỡ
gở	g ở
goá	g o á
góc	g ó c
gốc	g ố c
gộc	g ộ c
goes	g o e s
gói	g ó i
gối	g ố i
gọi	g ọ i
gởi	g ở i
gợi	g ợ i
golf	g o l f
gom	g o m
gồm	g ồ m
gớm	g ớ m
gờm	g ờ m
gòn	g ò n
gọn	g ọ n
gợn	g ợ n
gồng	g ồ n g
gọng	g ọ n g
google	g o o g l e
góp	g ó p
gộp	g ộ p
gót	g ó t
govorovo	g o v o r o v o
grace	g r a c e
grants	g r a n t s
gù	g ù
gục	g ụ c
gùi	g ù i
gửi	g ử i
guitar	g u i t a r
gumbly	g u m b l y
guốc	g u ố c
guộc	g u ộ c
gươm	g ư ơ m
gườm	g ư ờ m
gương	g ư ơ n g
gượng	g ư ợ n g
gutfreund	g u t f r e u n d
h	h
ha	h a
há	h á
hà	h à
hả	h ả
hạ	h ạ
hắc	h ắ c
hạc	h ạ c
hách	h á c h
hahalúc	h a h a l ú c
hai	h a i
haị	h a ị
hái	h á i
hài	h à i
hãi	h ã i
hãị	h ã ị
hải	h ả i
hảị	h ả ị
hại	h ạ i
hạị	h ạ ị
haiamột	h a i a m ộ t
haid	h a i d
haih	h a i h
haihba	h a i h b a
hainhấn	h a i n h ấ n
haiz	h a i z
ham	h a m
hàm	h à m
hăm	h ă m
hằm	h ằ m
hâm	h â m
hầm	h ầ m
hậm	h ậ m
hãm	h ã m
han	h a n
hán	h á n
hàn	h à n
hăn	h ă n
hắn	h ắ n
hằn	h ằ n
hẳn	h ẳ n
hân	h â n
hấn	h ấ n
hận	h ậ n
hãn	h ã n
hạn	h ạ n
hang	h a n g
hàng	h à n g
hăng	h ă n g
hắng	h ắ n g
hằng	h ằ n g
hẳng	h ẳ n g
hãng	h ã n g
hạng	h ạ n g
hành	h à n h
hãnh	h ã n h
hạnh	h ạ n h
hảnhỏ	h ả n h ỏ
hao	h a o
háo	h á o
hào	h à o
hảo	h ả o
hảọ	h ả ọ
hạo	h ạ o
hấp	h ấ p
hát	h á t
hắt	h ắ t
hất	h ấ t
hạt	h ạ t
hấtthằng	h ấ t t h ằ n g
hâu	h â u
hấu	h ấ u
hầu	h ầ u
hậu	h ậ u
hầụ	h ầ ụ
hay	h a y
haỵ	h a ỵ
hãy	h ã y
hazzz	h a z z z
hcm	h c m
hcmhồng	h c m h ồ n g
hé	h é
hè	h è
hê	h ê
hề	h ề
hễ	h ễ
hể	h ể
hệ	h ệ
heel	h e e l
hehe	h e h e
hẻm	h ẻ m
hen	h e n
hèn	h è n
hến	h ế n
hển	h ể n
hẹn	h ẹ n
hennigan	h e n n i g a n
heo	h e o
héo	h é o
hẻo	h ẻ o
hẹp	h ẹ p
hét	h é t
hết	h ế t
hệt	h ệ t
hi	h i
hí	h í
hì	h ì
hỉ	h ỉ
hiếm	h i ế m
hiềm	h i ề m
hiểm	h i ể m
hiên	h i ê n
hiến	h i ế n
hiền	h i ề n
hiển	h i ể n
hiện	h i ệ n
hiếp	h i ế p
hiệp	h i ệ p
hiếu	h i ế u
hiểu	h i ể u
hiệu	h i ệ u
hiếụ	h i ế ụ
hills	h i l l s
hime	h i m e
hinh	h i n h
hình	h ì n h
hít	h í t
hiu	h i u
hiụ	h i ụ
hiy	h i y
hkd	h k d
hkkhông	h k k h ô n g
hkmột	h k m ộ t
hlv	h l v
hmông	h m ô n g
ho	h o
hò	h ò
hô	h ô
hố	h ố
hồ	h ồ
hỗ	h ỗ
hổ	h ổ
hộ	h ộ
họ	h ọ
hờ	h ờ
hở	h ở
hoa	h o a
hoá	h o á
hoà	h o à
hoả	h o ả
hoạ	h o ạ
hòạ	h ò ạ
họạ	h ọ ạ
hoác	h o á c
hoắc	h o ắ c
hoặc	h o ặ c
hoạch	h o ạ c h
hoài	h o à i
hoại	h o ạ i
hoạị	h o ạ ị
hoẵm	h o ẵ m
hoan	h o a n
hoán	h o á n
hoàn	h o à n
hoãn	h o ã n
hoản	h o ả n
hoạn	h o ạ n
hoang	h o a n g
hoàng	h o à n g
hoằng	h o ằ n g
hoảng	h o ả n g
hoành	h o à n h
hoạt	h o ạ t
hoay	h o a y
hóc	h ó c
hốc	h ố c
hộc	h ộ c
học	h ọ c
hoen	h o e n
hoi	h o i
hòi	h ò i
hôi	h ô i
hối	h ố i
hồi	h ồ i
hổi	h ổ i
hội	h ộ i
hộị	h ộ ị
hỏi	h ỏ i
hỏị	h ỏ ị
hơi	h ơ i
hời	h ờ i
hỡi	h ỡ i
hóm	h ó m
hôm	h ô m
hợm	h ợ m
hon	h o n
hòn	h ò n
hôn	h ô n
hồn	h ồ n
hỗn	h ỗ n
hổn	h ổ n
hơn	h ơ n
hớn	h ớ n
hờn	h ờ n
hong	h o n g
hóng	h ó n g
hòng	h ò n g
hông	h ô n g
hống	h ố n g
hồng	h ồ n g
hỏng	h ỏ n g
họng	h ọ n g
hộp	h ộ p
họp	h ọ p
hớp	h ớ p
hợp	h ợ p
hót	h ó t
hốt	h ố t
hột	h ộ t
hợt	h ợ t
house	h o u s e
hu	h u
hú	h ú
hũ	h ũ
hủ	h ủ
hư	h ư
hứ	h ứ
hừ	h ừ
hử	h ử
hự	h ự
hùa	h ù a
hứa	h ứ a
huân	h u â n
huấn	h u ấ n
húc	h ú c
hức	h ứ c
hực	h ự c
huê	h u ê
huệ	h u ệ
húi	h ú i
hùm	h ù m
hun	h u n
hung	h u n g
hùng	h ù n g
hưng	h ư n g
hứng	h ứ n g
hừng	h ừ n g
hững	h ữ n g
hửng	h ử n g
huoai	h u o a i
hước	h ư ớ c
huống	h u ố n g
hương	h ư ơ n g
hướng	h ư ớ n g
hường	h ư ờ n g
hưởng	h ư ở n g
hươu	h ư ơ u
húp	h ú p
hus	h u s
husky	h u s k y
hút	h ú t
hụt	h ụ t
hưu	h ư u
hữu	h ữ u
hữụ	h ữ ụ
huy	h u y
huỷ	h u ỷ
huých	h u ý c h
huỵch	h u ỵ c h
huyên	h u y ê n
huyền	h u y ề n
huyện	h u y ệ n
huyết	h u y ế t
huyệt	h u y ệ t
huynh	h u y n h
huỳnh	h u ỳ n h
huýt	h u ý t
hy	h y
hý	h ý
ĩ	ĩ
ỉ	ỉ
ị	ị
ia	i a
ibie	i b i e
ích	í c h
ii	i i
im	i m
imduy	i m d u y
in	i n
ỉn	ỉ n
indonesia	i n d o n e s i a
insight	i n s i g h t
instagram	i n s t a g r a m
internet	i n t e r n e t
ireland	i r e l a n d
ít	í t
italy	i t a l y
jack	a c k
james	a m e s
jamiul	a m i u l
jean	e a n
jeep	e e p
jie	i e
jiejie	i e i e
john	o h n
jpl	p l
kaguya	k a g u y a
kalenđa	k a l e n đ a
kalenđan	k a l e n đ a n
kan	k a n
kanmưc	k a n m ư c
kanmức	k a n m ứ c
karaoke	k a r a o k e
karnataka	k a r n a t a k a
kayleen	k a y l e e n
kcn	k c n
kê	k ê
kế	k ế
kề	k ề
kể	k ể
kệ	k ệ
kẽ	k ẽ
kẻ	k ẻ
keel	k e e l
keep	k e e p
kelađan	k e l a đ a n
kem	k e m
kém	k é m
kèm	k è m
kềm	k ề m
ken	k e n
kén	k é n
kèn	k è n
keng	k e n g
kênh	k ê n h
keo	k e o
kéo	k é o
kèo	k è o
kẽo	k ẽ o
kẻo	k ẻ o
kẹo	k ẹ o
kẹp	k ẹ p
kerim	k e r i m
kerr	k e r r
kessler	k e s s l e r
két	k é t
kết	k ế t
kẹt	k ẹ t
kêu	k ê u
kêụ	k ê ụ
kg	k g
kha	k h a
khá	k h á
khà	k h à
khả	k h ả
khác	k h á c
khắc	k h ắ c
khạc	k h ạ c
khách	k h á c h
khai	k h a i
khái	k h á i
khải	k h ả i
kham	k h a m
khám	k h á m
khâm	k h â m
khấm	k h ấ m
khan	k h a n
khán	k h á n
khàn	k h à n
khăn	k h ă n
khấn	k h ấ n
khẩn	k h ẩ n
kháng	k h á n g
khăng	k h ă n g
khẳng	k h ẳ n g
khanh	k h a n h
khánh	k h á n h
khao	k h a o
khảo	k h ả o
khắp	k h ắ p
khập	k h ậ p
khát	k h á t
khắt	k h ắ t
khất	k h ấ t
kháu	k h á u
khâu	k h â u
khấu	k h ấ u
khẩu	k h ẩ u
khấụ	k h ấ ụ
khaxan	k h a x a n
khấy	k h ấ y
khẩy	k h ẩ y
khe	k h e
khế	k h ế
khẽ	k h ẽ
khen	k h e n
khéo	k h é o
khép	k h é p
khét	k h é t
khêu	k h ê u
khều	k h ề u
khi	k h i
khí	k h í
khỉ	k h ỉ
khịa	k h ị a
khích	k h í c h
khiêm	k h i ê m
khiên	k h i ê n
khiến	k h i ế n
khiển	k h i ể n
khiêng	k h i ê n g
khiễng	k h i ễ n g
khiếp	k h i ế p
khiết	k h i ế t
khiêu	k h i ê u
khiếu	k h i ế u
khinh	k h i n h
khỉnh	k h ỉ n h
khít	k h í t
kho	k h o
khó	k h ó
khô	k h ô
khổ	k h ổ
khơ	k h ơ
khoa	k h o a
khoá	k h o á
khoả	k h o ả
khoác	k h o á c
khoái	k h o á i
khoan	k h o a n
khoăn	k h o ă n
khoản	k h o ả n
khoang	k h o a n g
khoáng	k h o á n g
khoảng	k h o ả n g
khoanh	k h o a n h
khoảnh	k h o ả n h
khoát	k h o á t
khoắt	k h o ắ t
khóc	k h ó c
khốc	k h ố c
khoe	k h o e
khoé	k h o é
khoẻ	k h o ẻ
khỏẹ	k h ỏ ẹ
khoét	k h o é t
khôg	k h ô g
khói	k h ó i
khôi	k h ô i
khối	k h ố i
khỏi	k h ỏ i
khỏị	k h ỏ ị
khơi	k h ơ i
khởi	k h ở i
khởị	k h ở ị
khôn	k h ô n
khốn	k h ố n
không	k h ô n g
khống	k h ố n g
khổng	k h ổ n g
khôngamột	k h ô n g a m ộ t
khôngcm	k h ô n g c m
khôngđ	k h ô n g đ
khôngh	k h ô n g h
khôngkm	k h ô n g k m
khôngml	k h ô n g m l
khôngmm	k h ô n g m m
khôngxbốn	k h ô n g x b ố n
khôngxsáu	k h ô n g x s á u
khônng	k h ô n n g
khớp	k h ớ p
khu	k h u
khụ	k h ụ
khứ	k h ứ
khử	k h ử
khua	k h u a
khứa	k h ứ a
khuân	k h u â n
khuẩn	k h u ẩ n
khuất	k h u ấ t
khuây	k h u â y
khuấy	k h u ấ y
khúc	k h ú c
khúm	k h ú m
khung	k h u n g
khùng	k h ù n g
khủng	k h ủ n g
khước	k h ư ớ c
khuổi	k h u ổ i
khuôn	k h u ô n
khướt	k h ư ớ t
khưu	k h ư u
khứu	k h ứ u
khuy	k h u y
khuỵ	k h u ỵ
khuya	k h u y a
khuyên	k h u y ê n
khuyến	k h u y ế n
khuyết	k h u y ế t
khuynh	k h u y n h
kí	k í
kì	k ì
kĩ	k ĩ
kỉ	k ỉ
kị	k ị
kia	k i a
kiạ	k i ạ
kìa	k ì a
kích	k í c h
kịch	k ị c h
kiêm	k i ê m
kiếm	k i ế m
kiềm	k i ề m
kiểm	k i ể m
kiệm	k i ệ m
kiên	k i ê n
kiến	k i ế n
kiện	k i ệ n
kiêng	k i ê n g
kiếp	k i ế p
kiết	k i ế t
kiệt	k i ệ t
kiêu	k i ê u
kiếu	k i ế u
kiều	k i ề u
kiểu	k i ể u
kiệu	k i ệ u
kim	k i m
kìm	k ì m
kín	k í n
kinh	k i n h
kính	k í n h
kình	k ì n h
kíp	k í p
kịp	k ị p
kịt	k ị t
kittyd	k i t t y d
km	k m
ko	k o
kơ	k ơ
kong	k o n g
kuan	k u a n
kumức	k u m ứ c
ký	k ý
kỳ	k ỳ
kỹ	k ỹ
kỷ	k ỷ
kỵ	k ỵ
la	l a
lá	l á
là	l à
lã	l ã
lả	l ả
lạ	l ạ
lác	l á c
lắc	l ắ c
lạc	l ạ c
lách	l á c h
lai	l a i
laị	l a ị
lái	l á i
lãi	l ã i
lại	l ạ i
lạị	l ạ ị
lạimày	l ạ i m à y
lạiwtf	l ạ i t f
lake	l a k e
lam	l a m
làm	l à m
lăm	l ă m
lắm	l ắ m
lâm	l â m
lấm	l ấ m
lầm	l ầ m
lẫm	l ẫ m
lẩm	l ẩ m
lãm	l ã m
lan	l a n
làn	l à n
lăn	l ă n
lằn	l ằ n
lặn	l ặ n
lân	l â n
lấn	l ấ n
lần	l ầ n
lẫn	l ẫ n
lẩn	l ẩ n
lận	l ậ n
lãn	l ã n
lạn	l ạ n
lang	l a n g
láng	l á n g
làng	l à n g
lăng	l ă n g
lắng	l ắ n g
lẳng	l ẳ n g
lặng	l ặ n g
lâng	l â n g
lãng	l ã n g
lảng	l ả n g
lạng	l ạ n g
lanh	l a n h
lánh	l á n h
lành	l à n h
lãnh	l ã n h
lảnh	l ả n h
lạnh	l ạ n h
lao	l a o
laọ	l a ọ
láo	l á o
lão	l ã o
lãọ	l ã ọ
lảo	l ả o
lắp	l ắ p
lặp	l ặ p
lấp	l ấ p
lập	l ậ p
lạp	l ạ p
lát	l á t
lặt	l ặ t
lất	l ấ t
lật	l ậ t
lau	l a u
láu	l á u
làu	l à u
lâu	l â u
lầu	l ầ u
lâụ	l â ụ
lay	l a y
láy	l á y
lây	l â y
lấy	l ấ y
lầy	l ầ y
lẫy	l ẫ y
lẩy	l ẩ y
lâỵ	l â ỵ
lấỵ	l ấ ỵ
lẫỵ	l ẫ ỵ
lạy	l ạ y
lạỵ	l ạ ỵ
le	l e
lè	l è
lê	l ê
lề	l ề
lễ	l ễ
lệ	l ệ
lẽ	l ẽ
lẻ	l ẻ
lẹ	l ẹ
lệch	l ệ c h
lem	l e m
lẹm	l ẹ m
len	l e n
lén	l é n
lên	l ê n
lẽn	l ẽ n
lẻn	l ẻ n
lẹn	l ẹ n
lênem	l ê n e m
leng	l e n g
lệnh	l ệ n h
lệnhd	l ệ n h d
leo	l e o
léo	l é o
lẽo	l ẽ o
leon	l e o n
leonadventurecat	l e o n a d v e n t u r e c a t
lép	l é p
lét	l é t
lếu	l ế u
lều	l ề u
lever	l e v e r
li	l i
lí	l í
lì	l ì
lị	l ị
lia	l i a
lìa	l ì a
lìạ	l ì ạ
liam	l i a m
lịch	l ị c h
liếc	l i ế c
liem	l i e m
liêm	l i ê m
liếm	l i ế m
liễm	l i ễ m
liên	l i ê n
liền	l i ề n
liêng	l i ê n g
liệng	l i ệ n g
liệt	l i ệ t
liêu	l i ê u
liều	l i ề u
liễu	l i ễ u
liệu	l i ệ u
liêụ	l i ê ụ
liệụ	l i ệ ụ
lilibe	l i l i b e
lilibet	l i l i b e t
lim	l i m
limousine	l i m o u s i n e
lincoln	l i n c o l n
linh	l i n h
lính	l í n h
lình	l ì n h
lĩnh	l ĩ n h
lít	l í t
líu	l í u
lo	l o
ló	l ó
lò	l ò
lô	l ô
lố	l ố
lồ	l ồ
lỗ	l ỗ
lổ	l ổ
lộ	l ộ
lọ	l ọ
lơ	l ơ
lờ	l ờ
lỡ	l ỡ
lở	l ở
loa	l o a
loá	l o á
loà	l o à
loài	l o à i
loại	l o ạ i
loan	l o a n
loạn	l o ạ n
loang	l o a n g
loáng	l o á n g
loằng	l o ằ n g
loát	l o á t
loạt	l o ạ t
loay	l o a y
lóc	l ó c
lốc	l ố c
lộc	l ộ c
lọc	l ọ c
loé	l o é
loè	l o è
lòẹ	l ò ẹ
logic	l o g i c
loi	l o i
lói	l ó i
lòi	l ò i
lôi	l ô i
lối	l ố i
lồi	l ồ i
lỗi	l ỗ i
lội	l ộ i
lỏi	l ỏ i
lơi	l ơ i
lới	l ớ i
lời	l ờ i
lợi	l ợ i
lờị	l ờ ị
lóm	l ó m
lõm	l õ m
lợm	l ợ m
lón	l ó n
lòn	l ò n
lôn	l ô n
lộn	l ộ n
lớn	l ớ n
lợn	l ợ n
long	l o n g
lóng	l ó n g
lòng	l ò n g
lông	l ô n g
lồng	l ồ n g
lộng	l ộ n g
lõng	l õ n g
lỏng	l ỏ n g
lọng	l ọ n g
lốp	l ố p
lớp	l ớ p
lót	l ó t
lốt	l ố t
lột	l ộ t
lọt	l ọ t
lợt	l ợ t
lũ	l ũ
lụ	l ụ
lư	l ư
lừ	l ừ
lử	l ử
lự	l ự
lúa	l ú a
lùa	l ù a
lụa	l ụ a
lứa	l ứ a
lừa	l ừ a
lửa	l ử a
lựa	l ự a
lửạ	l ử ạ
luân	l u â n
luận	l u ậ n
luật	l u ậ t
lúc	l ú c
lục	l ụ c
lực	l ự c
lui	l u i
luị	l u ị
lùi	l ù i
lũi	l ũ i
lủi	l ủ i
luis	l u i s
lum	l u m
lùm	l ù m
lún	l ú n
lùn	l ù n
lung	l u n g
lúng	l ú n g
lùng	l ù n g
lũng	l ũ n g
lủng	l ủ n g
lụng	l ụ n g
lưng	l ư n g
lừng	l ừ n g
lửng	l ử n g
luộc	l u ộ c
lược	l ư ợ c
lừoi	l ừ o i
lưới	l ư ớ i
lười	l ư ờ i
lưỡi	l ư ỡ i
lượm	l ư ợ m
luôn	l u ô n
luồn	l u ồ n
lươn	l ư ơ n
lượn	l ư ợ n
lượnem	l ư ợ n e m
luông	l u ô n g
luống	l u ố n g
luồng	l u ồ n g
lương	l ư ơ n g
lường	l ư ờ n g
lưỡng	l ư ỡ n g
lưởng	l ư ở n g
lượng	l ư ợ n g
lượnsau	l ư ợ n s a u
lướt	l ư ớ t
lượt	l ư ợ t
lút	l ú t
lụt	l ụ t
lưu	l ư u
luxembourg	l u x e m b o u r g
luỹ	l u ỹ
luỵ	l u ỵ
luyến	l u y ế n
luyện	l u y ệ n
luýnh	l u ý n h
ly	l y
lý	l ý
lỳ	l ỳ
m	m
ma	m a
má	m á
mà	m à
mã	m ã
mạ	m ạ
mác	m á c
mắc	m ắ c
mặc	m ặ c
mạc	m ạ c
mách	m á c h
mạch	m ạ c h
mai	m a i
maị	m a ị
mái	m á i
mài	m à i
mãi	m ã i
mãị	m ã ị
mải	m ả i
mại	m ạ i
makeup	m a k e u p
măm	m ă m
mâm	m â m
mầm	m ầ m
man	m a n
mán	m á n
màn	m à n
mắn	m ắ n
mặn	m ặ n
mân	m â n
mẫn	m ẫ n
mãn	m ã n
mạn	m ạ n
mang	m a n g
màng	m à n g
măng	m ă n g
mắng	m ắ n g
mãng	m ã n g
mảng	m ả n g
mạng	m ạ n g
manh	m a n h
mãnh	m ã n h
mảnh	m ả n h
mạnh	m ạ n h
manhattan	m a n h a t t a n
mao	m a o
máo	m á o
mào	m à o
mạo	m ạ o
map	m a p
mấp	m ấ p
mập	m ậ p
marie	m a r i e
marina	m a r i n a
mars	m a r s
martin	m a r t i n
martina	m a r t i n a
masterson	m a s t e r s o n
mát	m á t
mắt	m ắ t
mặt	m ặ t
mất	m ấ t
mật	m ậ t
mạt	m ạ t
màtrên	m à t r ê n
mau	m a u
maụ	m a ụ
máu	m á u
máụ	m á ụ
màu	m à u
mâu	m â u
mấu	m ấ u
mầu	m ầ u
mẫu	m ẫ u
mẩu	m ẩ u
mậu	m ậ u
may	m a y
maỵ	m a ỵ
máy	m á y
mày	m à y
màỵ	m à ỵ
mây	m â y
mấy	m ấ y
mẩy	m ẩ y
mấỵ	m ấ ỵ
mảy	m ả y
mc	m c
mdf	m d f
me	m e
mê	m ê
mề	m ề
mẽ	m ẽ
mẻ	m ẻ
mẹ	m ẹ
mean	m e a n
megan	m e g a n
melamin	m e l a m i n
mềm	m ề m
men	m e n
mến	m ế n
mền	m ề n
mênh	m ê n h
mệnh	m ệ n h
meo	m e o
méo	m é o
mèo	m è o
mẹo	m ẹ o
mép	m é p
mét	m é t
mệt	m ệ t
methane	m e t h a n e
méttám	m é t t á m
mếu	m ế u
mexico	m e x i c o
mi	m i
mí	m í
mì	m ì
mĩ	m ĩ
mỉ	m ỉ
mị	m ị
mỉa	m ỉ a
mic	m i c
mích	m í c h
mịch	m ị c h
miên	m i ê n
miến	m i ế n
miền	m i ề n
miễn	m i ễ n
miếng	m i ế n g
miệng	m i ệ n g
miệngngay	m i ệ n g n g a y
miết	m i ế t
miệt	m i ệ t
miêu	m i ê u
miếu	m i ế u
miều	m i ề u
miêụ	m i ê ụ
mím	m í m
mĩm	m ĩ m
mỉm	m ỉ m
mịn	m ị n
minh	m i n h
mình	m ì n h
minnied	m i n n i e d
mít	m í t
mịt	m ị t
ml	m l
mm	m m
mò	m ò
mô	m ô
mồ	m ồ
mổ	m ổ
mộ	m ộ
mõ	m õ
mỏ	m ỏ
mơ	m ơ
mờ	m ờ
mỡ	m ỡ
mở	m ở
mợ	m ợ
móc	m ó c
mốc	m ố c
mộc	m ộ c
mọc	m ọ c
moi	m o i
mói	m ó i
môi	m ô i
mối	m ố i
mồi	m ồ i
mỗi	m ỗ i
mồị	m ồ ị
mõi	m õ i
mỏi	m ỏ i
mọi	m ọ i
mới	m ớ i
mời	m ờ i
mớị	m ớ ị
mớiduy	m ớ i d u y
mớimột	m ớ i m ộ t
mồm	m ồ m
món	m ó n
mòn	m ò n
môn	m ô n
mồn	m ồ n
mọn	m ọ n
mơn	m ơ n
mong	m o n g
móng	m ó n g
mông	m ô n g
mống	m ố n g
mộng	m ộ n g
mỏng	m ỏ n g
moscow	m o s c o
mốt	m ố t
một	m ộ t
mộth	m ộ t h
mộtmbảy	m ộ t m b ả y
mộtnhấn	m ộ t n h ấ n
mộtvsmột	m ộ t v s m ộ t
mu	m u
mú	m ú
mù	m ù
mũ	m ũ
mủ	m ủ
mụ	m ụ
mua	m u a
múa	m ú a
mùa	m ù a
mưa	m ư a
mửa	m ử a
mưạ	m ư ạ
múc	m ú c
mục	m ụ c
mức	m ứ c
mực	m ự c
muhican	m u h i c a n
mui	m u i
mùi	m ù i
mũi	m ũ i
mũm	m ũ m
mụn	m ụ n
mừng	m ừ n g
muỗi	m u ỗ i
muội	m u ộ i
mươi	m ư ơ i
mười	m ư ờ i
mươị	m ư ơ ị
muôn	m u ô n
muốn	m u ố n
muộn	m u ộ n
mướn	m ư ớ n
mượn	m ư ợ n
muông	m u ô n g
muống	m u ố n g
muỗng	m u ỗ n g
mương	m ư ơ n g
mường	m ư ờ n g
muốt	m u ố t
mướt	m ư ớ t
mượt	m ư ợ t
mút	m ú t
mưu	m ư u
my	m y
mỹ	m ỹ
myanmar	m y a n m a r
mỹmột	m ỹ m ộ t
mỹrượu	m ỹ r ư ợ u
mỹvào	m ỹ v à o
na	n a
ná	n á
nà	n à
nã	n ã
nặc	n ặ c
nấc	n ấ c
nách	n á c h
nagasawa	n a g a s a a
nai	n a i
nài	n à i
nải	n ả i
nam	n a m
năm	n ă m
nắm	n ắ m
nằm	n ằ m
nặm	n ặ m
nấm	n ấ m
nạm	n ạ m
nămm	n ă m m
nămp	n ă m p
nan	n a n
nàn	n à n
năn	n ă n
nặn	n ặ n
nân	n â n
nấn	n ấ n
nần	n ầ n
nản	n ả n
nạn	n ạ n
nang	n a n g
nàng	n à n g
năng	n ă n g
nắng	n ắ n g
nẵng	n ẵ n g
nặng	n ặ n g
nâng	n â n g
nấng	n ấ n g
náo	n á o
náọ	n á ọ
nào	n à o
nàỏ	n à ỏ
nàọ	n à ọ
não	n ã o
nắp	n ắ p
nấp	n ấ p
nập	n ậ p
nạp	n ạ p
nasa	n a s a
nát	n á t
nạt	n ạ t
náu	n á u
nâu	n â u
nấu	n ấ u
nay	n a y
naỵ	n a ỵ
náy	n á y
này	n à y
nàỷ	n à ỷ
nàỵ	n à ỵ
nấy	n ấ y
nầy	n ầ y
nẩy	n ẩ y
nầỷ	n ầ ỷ
nãy	n ã y
nảy	n ả y
nbk	n b k
né	n é
nè	n è
nê	n ê
nề	n ề
nể	n ể
nệ	n ệ
ném	n é m
nếm	n ế m
nệm	n ệ m
nén	n é n
nên	n ê n
nến	n ế n
nền	n ề n
nện	n ệ n
neo	n e o
nép	n é p
nếp	n ế p
nét	n é t
nết	n ế t
nêu	n ê u
nếu	n ế u
new	n e
news	n e s
nga	n g a
ngà	n g à
ngã	n g ã
ngả	n g ả
ngác	n g á c
ngắc	n g ắ c
ngạc	n g ạ c
ngách	n g á c h
ngai	n g a i
ngái	n g á i
ngài	n g à i
ngại	n g ạ i
ngạị	n g ạ ị
ngắm	n g ắ m
ngâm	n g â m
ngấm	n g ấ m
ngầm	n g ầ m
ngẫm	n g ẫ m
ngậm	n g ậ m
ngán	n g á n
ngàn	n g à n
ngăn	n g ă n
ngắn	n g ắ n
ngân	n g â n
ngấn	n g ấ n
ngần	n g ầ n
ngẩn	n g ẩ n
ngang	n g a n g
ngáng	n g á n g
ngẩng	n g ẩ n g
ngành	n g à n h
ngạnh	n g ạ n h
ngao	n g a o
ngaọ	n g a ọ
ngáo	n g á o
ngào	n g à o
ngàọ	n g à ọ
ngạo	n g ạ o
ngạọ	n g ạ ọ
ngáp	n g á p
ngấp	n g ấ p
ngập	n g ậ p
ngát	n g á t
ngắt	n g ắ t
ngặt	n g ặ t
ngất	n g ấ t
ngạt	n g ạ t
ngấu	n g ấ u
ngẫu	n g ẫ u
ngay	n g a y
ngaỵ	n g a ỵ
ngáy	n g á y
ngày	n g à y
ngàỵ	n g à ỵ
ngây	n g â y
ngậy	n g ậ y
ngèo	n g è o
nghành	n g h à n h
nghạnh	n g h ạ n h
nghe	n g h e
nghé	n g h é
nghề	n g h ề
nghễ	n g h ễ
nghệ	n g h ệ
nghẹ	n g h ẹ
nghếch	n g h ế c h
nghẹn	n g h ẹ n
nghênh	n g h ê n h
nghèo	n g h è o
nghét	n g h é t
nghẹt	n g h ẹ t
nghi	n g h i
nghĩ	n g h ĩ
nghỉ	n g h ỉ
nghị	n g h ị
nghía	n g h í a
nghĩa	n g h ĩ a
nghĩạ	n g h ĩ ạ
nghịch	n g h ị c h
nghiêm	n g h i ê m
nghiễm	n g h i ễ m
nghiệm	n g h i ệ m
nghiên	n g h i ê n
nghiến	n g h i ế n
nghiền	n g h i ề n
nghiện	n g h i ệ n
nghiêng	n g h i ê n g
nghiệp	n g h i ệ p
nghiệt	n g h i ệ t
nghìn	n g h ì n
nghinh	n g h i n h
nghĩnh	n g h ĩ n h
nghịt	n g h ị t
ngó	n g ó
ngô	n g ô
ngố	n g ố
ngồ	n g ồ
ngổ	n g ổ
ngộ	n g ộ
ngõ	n g õ
ngỏ	n g ỏ
ngọ	n g ọ
ngơ	n g ơ
ngớ	n g ớ
ngờ	n g ờ
ngỡ	n g ỡ
ngoa	n g o a
ngoạ	n g o ạ
ngoắc	n g o ắ c
ngoái	n g o á i
ngoài	n g o à i
ngoàị	n g o à ị
ngoại	n g o ạ i
ngoạị	n g o ạ ị
ngoạm	n g o ạ m
ngoan	n g o a n
ngoằn	n g o ằ n
ngoãn	n g o ã n
ngoạn	n g o ạ n
ngoằng	n g o ằ n g
ngoảnh	n g o ả n h
ngoắt	n g o ắ t
ngóc	n g ó c
ngốc	n g ố c
ngọc	n g ọ c
ngoèo	n g o è o
ngoèu	n g o è u
ngôi	n g ô i
ngồi	n g ồ i
ngồị	n g ồ ị
ngơi	n g ơ i
ngời	n g ờ i
ngợi	n g ợ i
ngơị	n g ơ ị
ngờị	n g ờ ị
ngóm	n g ó m
ngợm	n g ợ m
ngon	n g o n
ngón	n g ó n
ngòn	n g ò n
ngôn	n g ô n
ngổn	n g ổ n
ngọn	n g ọ n
ngớn	n g ớ n
ngông	n g ô n g
ngỗng	n g ỗ n g
ngộp	n g ộ p
ngợp	n g ợ p
ngót	n g ó t
ngột	n g ộ t
ngọt	n g ọ t
ngớt	n g ớ t
ngu	n g u
ngũ	n g ũ
ngủ	n g ủ
ngụ	n g ụ
ngư	n g ư
ngừ	n g ừ
ngữ	n g ữ
ngự	n g ự
ngứa	n g ứ a
ngửa	n g ử a
ngựa	n g ự a
ngửạ	n g ử ạ
ngục	n g ụ c
ngực	n g ự c
ngùi	n g ù i
ngủi	n g ủ i
ngửi	n g ử i
ngúm	n g ú m
ngụm	n g ụ m
ngùn	n g ù n
ngủn	n g ủ n
ngưng	n g ư n g
ngừng	n g ừ n g
ngửng	n g ử n g
ngước	n g ư ớ c
ngược	n g ư ợ c
nguội	n g u ộ i
ngươi	n g ư ơ i
người	n g ư ờ i
ngườỉ	n g ư ờ ỉ
ngươị	n g ư ơ ị
ngườị	n g ư ờ ị
ngườikhông	n g ư ờ i k h ô n g
nguồn	n g u ồ n
ngưỡng	n g ư ỡ n g
ngượng	n g ư ợ n g
ngút	n g ú t
ngụt	n g ụ t
ngưu	n g ư u
nguy	n g u y
nguỵ	n g u ỵ
nguyên	n g u y ê n
nguyền	n g u y ề n
nguyễn	n g u y ễ n
nguyện	n g u y ệ n
nguyệt	n g u y ệ t
nha	n h a
nhá	n h á
nhà	n h à
nhã	n h ã
nhả	n h ả
nhác	n h á c
nhắc	n h ắ c
nhấc	n h ấ c
nhạc	n h ạ c
nhai	n h a i
nhái	n h á i
nham	n h a m
nhám	n h á m
nhắm	n h ắ m
nhằm	n h ằ m
nhấm	n h ấ m
nhầm	n h ầ m
nhẩm	n h ẩ m
nhảm	n h ả m
nhắmcặp	n h ắ m c ặ p
nhan	n h a n
nhàn	n h à n
nhăn	n h ă n
nhắn	n h ắ n
nhẵn	n h ẵ n
nhẳn	n h ẳ n
nhân	n h â n
nhấn	n h ấ n
nhẫn	n h ẫ n
nhẩn	n h ẩ n
nhận	n h ậ n
nhãn	n h ã n
nhạn	n h ạ n
nhang	n h a n g
nháng	n h á n g
nhàng	n h à n g
nhằng	n h ằ n g
nhanh	n h a n h
nhánh	n h á n h
nhanhem	n h a n h e m
nhao	n h a o
nháo	n h á o
nhào	n h à o
nhạo	n h ạ o
nhấp	n h ấ p
nhập	n h ậ p
nhát	n h á t
nhặt	n h ặ t
nhât	n h â t
nhất	n h ấ t
nhật	n h ậ t
nhạt	n h ạ t
nhau	n h a u
nhaụ	n h a ụ
nhàu	n h à u
nhảu	n h ả u
nhauem	n h a u e m
nháy	n h á y
nhày	n h à y
nhẩy	n h ẩ y
nhảy	n h ả y
nhạy	n h ạ y
nhe	n h e
nhé	n h é
nhè	n h è
nhẽ	n h ẽ
nhẹ	n h ẹ
nhếc	n h ế c
nhếch	n h ế c h
nhẹm	n h ẹ m
nhẹn	n h ẹ n
nhénó	n h é n ó
nheo	n h e o
nhét	n h é t
nhi	n h i
nhỉ	n h ỉ
nhị	n h ị
nhia	n h i a
nhích	n h í c h
nhiếc	n h i ế c
nhiễm	n h i ễ m
nhiệm	n h i ệ m
nhỉem	n h ỉ e m
nhiên	n h i ê n
nhiếp	n h i ế p
nhiệt	n h i ệ t
nhiêu	n h i ê u
nhiều	n h i ề u
nhiễu	n h i ễ u
nhiêụ	n h i ê ụ
nhiềụ	n h i ề ụ
nhìn	n h ì n
nhỉn	n h ỉ n
nhịn	n h ị n
nhịp	n h ị p
nhịt	n h ị t
nhíu	n h í u
nho	n h o
nhó	n h ó
nhô	n h ô
nhố	n h ố
nhổ	n h ổ
nhỏ	n h ỏ
nhơ	n h ơ
nhớ	n h ớ
nhờ	n h ờ
nhở	n h ở
nhoài	n h o à i
nhoáng	n h o á n g
nhóc	n h ó c
nhọc	n h ọ c
nhoẻn	n h o ẻ n
nhoi	n h o i
nhói	n h ó i
nhối	n h ố i
nhồi	n h ồ i
nhóm	n h ó m
nhòm	n h ò m
nhổm	n h ổ m
nhõm	n h õ m
nhỏm	n h ỏ m
nhốn	n h ố n
nhộn	n h ộ n
nhọn	n h ọ n
nhỡn	n h ỡ n
nhởn	n h ở n
nhót	n h ó t
nhốt	n h ố t
nhợt	n h ợ t
nhu	n h u
nhũ	n h ũ
nhủ	n h ủ
nhụ	n h ụ
như	n h ư
nhừ	n h ừ
nhữ	n h ữ
nhụa	n h ụ a
nhựa	n h ự a
nhuận	n h u ậ n
nhúc	n h ú c
nhục	n h ụ c
nhức	n h ứ c
nhuệ	n h u ệ
nhụi	n h ụ i
nhụị	n h ụ ị
nhúm	n h ú m
nhún	n h ú n
nhũn	n h ũ n
nhủn	n h ủ n
nhung	n h u n g
nhúng	n h ú n g
nhưng	n h ư n g
những	n h ữ n g
nhược	n h ư ợ c
nhuộm	n h u ộ m
nhướn	n h ư ớ n
nhướng	n h ư ớ n g
nhường	n h ư ờ n g
nhượng	n h ư ợ n g
nhứt	n h ứ t
nhựt	n h ự t
nhuyễn	n h u y ễ n
nỉ	n ỉ
niạ	n i ạ
ních	n í c h
nịch	n ị c h
niềm	n i ề m
niệm	n i ệ m
niên	n i ê n
nín	n í n
ninh	n i n h
nịnh	n ị n h
ninhông	n i n h ô n g
nít	n í t
niu	n i u
niụ	n i ụ
níu	n í u
no	n o
nó	n ó
nô	n ô
nỗ	n ỗ
nổ	n ổ
nộ	n ộ
nọ	n ọ
nơ	n ơ
nỡ	n ỡ
nở	n ở
nợ	n ợ
noaa	n o a a
nobel	n o b e l
nóbọn	n ó b ọ n
nóc	n ó c
nốc	n ố c
nói	n ó i
nóị	n ó ị
nòi	n ò i
nôi	n ô i
nối	n ố i
nồi	n ồ i
nỗi	n ỗ i
nổi	n ổ i
nội	n ộ i
nổỉ	n ổ ỉ
nổị	n ổ ị
nỏi	n ỏ i
nơi	n ơ i
nới	n ớ i
nơị	n ơ ị
nộijohn	n ộ i o h n
nom	n o m
nơm	n ơ m
non	n o n
nón	n ó n
nôn	n ô n
nõn	n õ n
nong	n o n g
nóng	n ó n g
nòng	n ò n g
nông	n ô n g
nồng	n ồ n g
nộp	n ộ p
nớp	n ớ p
nốt	n ố t
nọt	n ọ t
nớt	n ớ t
npc	n p c
nttsáu	n t t s á u
nụ	n ụ
nữ	n ữ
nua	n u a
nưa	n ư a
nứa	n ứ a
nữa	n ữ a
nửa	n ử a
nữạ	n ữ ạ
nửạ	n ử ạ
nức	n ứ c
nực	n ự c
núi	n ú i
núị	n ú ị
núm	n ú m
nước	n ư ớ c
nuôi	n u ô i
nuối	n u ố i
nuông	n u ô n g
nương	n ư ơ n g
nướng	n ư ớ n g
nuốt	n u ố t
núp	n ú p
nút	n ú t
nứt	n ứ t
nữu	n ữ u
nvcc	n v c c
nylon	n y l o n
o	o
ó	ó
ô	ô
ố	ố
ồ	ồ
ổ	ổ
ỏ	ỏ
ơ	ơ
ớ	ớ
ờ	ờ
ở	ở
oa	o a
oà	o à
oai	o a i
oaị	o a ị
oái	o á i
oăm	o ă m
oan	o a n
oán	o á n
oang	o a n g
oắt	o ắ t
óc	ó c
ốc	ố c
oe	o e
offline	o f f l i n e
ôi	ô i
ối	ố i
ổi	ổ i
ơi	ơ i
ơimẹ	ơ i m ẹ
oing	o i n g
ok	o k
ol	o l
olganik	o l g a n i k
olimpico	o l i m p i c o
olympics	o l y m p i c s
om	o m
ôm	ô m
ốm	ố m
omg	o m g
omir	o m i r
ôn	ô n
ồn	ồ n
ổn	ổ n
ơn	ơ n
ớn	ớ n
ong	o n g
óng	ó n g
ông	ô n g
ống	ố n g
ổng	ổ n g
operation	o p e r a t i o n
oregon	o r e g o n
ớt	ớ t
ôtô	ô t ô
pác	p á c
panda	p a n d a
pari	p a r i
pass	p a s s
pause	p a u s e
pcr	p c r
penh	p e n h
peter	p e t e r
petersburg	p e t e r s b u r g
peterson	p e t e r s o n
pgs	p g s
pha	p h a
phá	p h á
phà	p h à
phả	p h ả
phác	p h á c
phách	p h á c h
phai	p h a i
phái	p h á i
pháị	p h á ị
phải	p h ả i
phàm	p h à m
phầm	p h ầ m
phẩm	p h ẩ m
phạm	p h ạ m
phan	p h a n
phán	p h á n
phàn	p h à n
phân	p h â n
phấn	p h ấ n
phần	p h ầ n
phẫn	p h ẫ n
phận	p h ậ n
phản	p h ả n
phang	p h a n g
phăng	p h ă n g
phẳng	p h ẳ n g
phảng	p h ả n g
phanh	p h a n h
pháo	p h á o
phào	p h à o
pháp	p h á p
phấp	p h ấ p
phập	p h ậ p
phát	p h á t
phắt	p h ắ t
phất	p h ấ t
phật	p h ậ t
phạt	p h ạ t
phaụ	p h a ụ
phẫu	p h ẫ u
phẩy	p h ẩ y
phe	p h e
phê	p h ê
phế	p h ế
phen	p h e n
phèo	p h è o
phép	p h é p
phết	p h ế t
phệt	p h ệ t
phi	p h i
phí	p h í
phì	p h ì
phị	p h ị
phia	p h i a
phía	p h í a
phịch	p h ị c h
phiếm	p h i ế m
phiên	p h i ê n
phiến	p h i ế n
phiền	p h i ề n
phiêu	p h i ê u
phiếu	p h i ế u
phim	p h i m
phím	p h í m
phình	p h ì n h
phịu	p h ị u
phnom	p h n o m
pho	p h o
phó	p h ó
phò	p h ò
phô	p h ô
phố	p h ố
phổ	p h ổ
phơ	p h ơ
phốc	p h ố c
phoenix	p h o e n i x
phối	p h ố i
phổi	p h ổ i
phơi	p h ơ i
phới	p h ớ i
phong	p h o n g
phóng	p h ó n g
phòng	p h ò n g
phông	p h ô n g
phồng	p h ồ n g
phỗng	p h ỗ n g
phỏng	p h ỏ n g
phọt	p h ọ t
phớt	p h ớ t
phu	p h u
phú	p h ú
phù	p h ù
phủ	p h ủ
phụ	p h ụ
phúc	p h ú c
phục	p h ụ c
phức	p h ứ c
phủi	p h ủ i
phun	p h u n
phùn	p h ù n
phung	p h u n g
phùng	p h ù n g
phụng	p h ụ n g
phừng	p h ừ n g
phước	p h ư ớ c
phương	p h ư ơ n g
phường	p h ư ờ n g
phượng	p h ư ợ n g
phượt	p h ư ợ t
phút	p h ú t
phụt	p h ụ t
pin	p i n
pinyin	p i n y i n
pk	p k
player	p l a y e r
pp	p p
ptsd	p t s d
pub	p u b
q	qu i
qua	q u a
quá	q u á
quà	q u à
quả	q u ả
quạ	q u ạ
qúa	ú a
quắc	q u ắ c
quách	q u á c h
quai	q u a i
quái	q u á i
quáị	q u á ị
quắm	q u ắ m
quan	q u a n
quán	q u á n
quân	q u â n
quấn	q u ấ n
quần	q u ầ n
quẫn	q u ẫ n
quẩn	q u ẩ n
quận	q u ậ n
quản	q u ả n
quang	q u a n g
quàng	q u à n g
quăng	q u ă n g
quẳng	q u ẳ n g
quãng	q u ã n g
quảng	q u ả n g
quanh	q u a n h
quánh	q u á n h
quạnh	q u ạ n h
quắp	q u ắ p
quặp	q u ặ p
quát	q u á t
quất	q u ấ t
quật	q u ậ t
quay	q u a y
quày	q u à y
quây	q u â y
quấy	q u ấ y
quầy	q u ầ y
quẫy	q u ẫ y
quậy	q u ậ y
quậỵ	q u ậ ỵ
que	q u e
què	q u è
quê	q u ê
quế	q u ế
quẻ	q u ẻ
queens	q u e e n s
quen	q u e n
quên	q u ê n
queo	q u e o
quẹo	q u ẹ o
quét	q u é t
quết	q u ế t
quẹt	q u ẹ t
qui	q u i
quí	q u í
quì	q u ì
qúi	ú i
quít	q u í t
quở	q u ở
qưở	ư ở
quốc	q u ố c
quy	q u y
quý	q u ý
quỳ	q u ỳ
quỹ	q u ỹ
quỷ	q u ỷ
quỵ	q u ỵ
quyên	q u y ê n
quyến	q u y ế n
quyền	q u y ề n
quyển	q u y ể n
quyện	q u y ệ n
quyết	q u y ế t
quyệt	q u y ệ t
quýnh	q u ý n h
quỳnh	q u ỳ n h
quýt	q u ý t
ra	r a
rà	r à
rã	r ã
rả	r ả
rạ	r ạ
rác	r á c
rắc	r ắ c
rạc	r ạ c
rách	r á c h
rạch	r ạ c h
rãi	r ã i
rải	r ả i
răm	r ă m
rằm	r ằ m
rấm	r ấ m
rầm	r ầ m
rậm	r ậ m
rán	r á n
răn	r ă n
rắn	r ắ n
rặn	r ặ n
rần	r ầ n
ráng	r á n g
ràng	r à n g
răng	r ă n g
rằng	r ằ n g
rẳng	r ẳ n g
rặng	r ặ n g
rảng	r ả n g
rạng	r ạ n g
ranh	r a n h
rành	r à n h
rãnh	r ã n h
rảnh	r ả n h
rao	r a o
ráo	r á o
ráọ	r á ọ
rào	r à o
ràọ	r à ọ
rảo	r ả o
ráp	r á p
rắp	r ắ p
rập	r ậ p
rạp	r ạ p
rát	r á t
rắt	r ắ t
rất	r ấ t
rạt	r ạ t
rau	r a u
râu	r â u
rầu	r ầ u
rầy	r ầ y
rẫy	r ẫ y
rẩy	r ẩ y
rầỵ	r ầ ỵ
rê	r ê
rễ	r ễ
rể	r ể
rẽ	r ẽ
rẻ	r ẻ
rea	r e a
recall	r e c a l l
rèm	r è m
ren	r e n
rén	r é n
rèn	r è n
rên	r ê n
rến	r ế n
rền	r ề n
rengreng	r e n g r e n g
reo	r e o
réo	r é o
respect	r e s p e c t
rét	r é t
rết	r ế t
rêu	r ê u
ri	r i
rì	r ì
rĩ	r ĩ
rỉ	r ỉ
ria	r i a
rích	r í c h
riêng	r i ê n g
riết	r i ế t
rinh	r i n h
rình	r ì n h
rỉnh	r ỉ n h
ripper	r i p p e r
rít	r í t
riu	r i u
ríu	r í u
rìu	r ì u
rô	r ô
rồ	r ồ
rộ	r ộ
rõ	r õ
rơ	r ơ
rỡ	r ỡ
rợ	r ợ
robot	r o b o t
róc	r ó c
roi	r o i
rối	r ố i
rồi	r ồ i
rồị	r ồ ị
rõi	r õ i
rỏi	r ỏ i
rọi	r ọ i
rơi	r ơ i
rời	r ờ i
rồikhông	r ồ i k h ô n g
rồingọc	r ồ i n g ọ c
rolex	r o l e x
rón	r ó n
ròn	r ò n
rốn	r ố n
rổn	r ổ n
rộn	r ộ n
rợn	r ợ n
rong	r o n g
ròng	r ò n g
rông	r ô n g
rống	r ố n g
rồng	r ồ n g
rỗng	r ỗ n g
rộng	r ộ n g
rót	r ó t
rốt	r ố t
rớt	r ớ t
ru	r u
rú	r ú
rũ	r ũ
rủ	r ủ
rùa	r ù a
rủa	r ủ a
rữa	r ữ a
rửa	r ử a
rúc	r ú c
rực	r ự c
rủi	r ủ i
rủị	r ủ ị
run	r u n
rủn	r ủ n
rung	r u n g
rúng	r ú n g
rùng	r ù n g
rụng	r ụ n g
rưng	r ư n g
rừng	r ừ n g
rước	r ư ớ c
ruồi	r u ồ i
ruổi	r u ổ i
ruổị	r u ổ ị
rưới	r ư ớ i
rưỡi	r ư ỡ i
rưởi	r ư ở i
rướm	r ư ớ m
rướn	r ư ớ n
ruộng	r u ộ n g
ruột	r u ộ t
rượt	r ư ợ t
rượu	r ư ợ u
rượụ	r ư ợ ụ
rúp	r ú p
rút	r ú t
rụt	r ụ t
rứt	r ứ t
sa	s a
sá	s á
sà	s à
sả	s ả
sạ	s ạ
sác	s á c
sắc	s ắ c
sặc	s ặ c
sách	s á c h
sạch	s ạ c h
sai	s a i
saị	s a ị
sài	s à i
sải	s ả i
saint	s a i n t
sakhra	s a k h r a
sakhragiađa	s a k h r a g i a đ a
salon	s a l o n
salt	s a l t
sam	s a m
sàm	s à m
sắm	s ắ m
sâm	s â m
sấm	s ấ m
sầm	s ầ m
sậm	s ậ m
samiran	s a m i r a n
san	s a n
sàn	s à n
săn	s ă n
sắn	s ắ n
sẵn	s ẵ n
sân	s â n
sấn	s ấ n
sần	s ầ n
sản	s ả n
sạn	s ạ n
sandwich	s a n d i c h
sang	s a n g
sáng	s á n g
sàng	s à n g
sắng	s ắ n g
sằng	s ằ n g
sảng	s ả n g
sanh	s a n h
sánh	s á n h
sảnh	s ả n h
sao	s a o
saỏ	s a ỏ
saọ	s a ọ
sáo	s á o
sào	s à o
sảo	s ả o
saothằng	s a o t h ằ n g
sáp	s á p
sắp	s ắ p
sấp	s ấ p
sập	s ậ p
sạp	s ạ p
sarah	s a r a h
saskylah	s a s k y l a h
sát	s á t
sắt	s ắ t
sạt	s ạ t
sau	s a u
saụ	s a ụ
sáu	s á u
sâu	s â u
sấu	s ấ u
sầu	s ầ u
sâụ	s â ụ
sầụ	s ầ ụ
sáuh	s á u h
sáuhba	s á u h b a
sául	s á u l
say	s a y
sẩy	s ẩ y
sảy	s ả y
sẽ	s ẽ
sẻ	s ẻ
sebastian	s e b a s t i a n
seiler	s e i l e r
sen	s e n
sẻn	s ẻ n
sentinel	s e n t i n e l
sẹo	s ẹ o
sếp	s ế p
sét	s é t
sệt	s ệ t
sẹt	s ẹ t
sevilla	s e v i l l a
shaii	s h a i i
shaiih	s h a i i h
shasta	s h a s t a
shop	s h o p
si	s i
sì	s ì
sĩ	s ĩ
sỉ	s ỉ
siberia	s i b e r i a
side	s i d e
siêng	s i ê n g
siết	s i ế t
siêu	s i ê u
siêụ	s i ê ụ
simili	s i m i l i
simily	s i m i l y
simmons	s i m m o n s
sing	s i n g
singh	s i n g h
sinh	s i n h
slovakia	s l o v a k i a
smile	s m i l e
sml	s m l
sms	s m s
so	s o
sô	s ô
số	s ố
sổ	s ổ
sộ	s ộ
sọ	s ọ
sơ	s ơ
sờ	s ờ
sở	s ở
sợ	s ợ
soái	s o á i
soài	s o à i
soắn	s o ắ n
soạn	s o ạ n
soát	s o á t
soạt	s o ạ t
sóc	s ó c
sốc	s ố c
sọc	s ọ c
soẹt	s o ẹ t
sofa	s o f a
soi	s o i
sói	s ó i
sôi	s ô i
sồi	s ồ i
sỏi	s ỏ i
sợi	s ợ i
solbon	s o l b o n
sòm	s ò m
sớm	s ớ m
sờm	s ờ m
son	s o n
sơn	s ơ n
sờn	s ờ n
sởn	s ở n
sonat	s o n a t
song	s o n g
sóng	s ó n g
sòng	s ò n g
sông	s ô n g
sống	s ố n g
sõng	s õ n g
sorry	s o r r y
sót	s ó t
sốt	s ố t
sột	s ộ t
sọt	s ọ t
sớt	s ớ t
sparky	s p a r k y
spokane	s p o k a n e
spy	s p y
star	s t a r
stem	s t e m
stephen	s t e p h e n
steven	s t e v e n
stone	s t o n e
stonehenge	s t o n e h e n g e
stuyvesant	s t u y v e s a n t
su	s u
sù	s ù
sụ	s ụ
sư	s ư
sứ	s ứ
sử	s ử
sự	s ự
sủa	s ủ a
sưa	s ư a
sữa	s ữ a
sửa	s ử a
sữả	s ữ ả
suất	s u ấ t
súc	s ú c
sức	s ứ c
sực	s ự c
sùi	s ù i
suki	s u k i
sukiicat	s u k i i c a t
sung	s u n g
súng	s ú n g
sùng	s ù n g
sủng	s ủ n g
sưng	s ư n g
sừng	s ừ n g
sững	s ữ n g
sửng	s ử n g
suối	s u ố i
suốị	s u ố ị
sưởi	s ư ở i
sườn	s ư ờ n
sườncơ	s ư ờ n c ơ
suông	s u ô n g
sương	s ư ơ n g
sướng	s ư ớ n g
sượng	s ư ợ n g
suốt	s u ố t
sướt	s ư ớ t
sượt	s ư ợ t
súp	s ú p
sụp	s ụ p
sút	s ú t
sứt	s ứ t
sưu	s ư u
sửu	s ử u
suy	s u y
suý	s u ý
suýt	s u ý t
systems	s y s t e m s
t	t
ta	t a
tá	t á
tà	t à
tã	t ã
tả	t ả
tạ	t ạ
tác	t á c
tắc	t ắ c
tặc	t ặ c
tấc	t ấ c
tạc	t ạ c
tách	t á c h
tai	t a i
taị	t a ị
tái	t á i
tài	t à i
tàị	t à ị
tải	t ả i
tại	t ạ i
talk	t a l k
tam	t a m
tám	t á m
tàm	t à m
tăm	t ă m
tắm	t ắ m
tâm	t â m
tấm	t ấ m
tầm	t ầ m
tẩm	t ẩ m
tạm	t ạ m
támcm	t á m c m
támh	t á m h
támkg	t á m k g
tan	t a n
tán	t á n
tàn	t à n
tăn	t ă n
tằn	t ằ n
tân	t â n
tấn	t ấ n
tần	t ầ n
tẫn	t ẫ n
tận	t ậ n
tản	t ả n
tạn	t ạ n
tang	t a n g
táng	t á n g
tàng	t à n g
tăng	t ă n g
tằng	t ằ n g
tặng	t ặ n g
tầng	t ầ n g
tảng	t ả n g
tanh	t a n h
tánh	t á n h
tành	t à n h
tao	t a o
táo	t á o
tào	t à o
tảo	t ả o
tạo	t ạ o
taoem	t a o e m
táp	t á p
tắp	t ắ p
tấp	t ấ p
tập	t ậ p
tạp	t ạ p
tát	t á t
tắt	t ắ t
tất	t ấ t
tật	t ậ t
tạt	t ạ t
tàu	t à u
tâu	t â u
tấu	t ấ u
tẩu	t ẩ u
tẩụ	t ẩ ụ
taxi	t a x i
tay	t a y
taỵ	t a ỵ
tày	t à y
tây	t â y
tấy	t ấ y
tâỵ	t â ỵ
te	t e
té	t é
tê	t ê
tế	t ế
tề	t ề
tễ	t ễ
tể	t ể
tệ	t ệ
tẻ	t ẻ
teed	t e e d
tem	t e m
temirbếch	t e m i r b ế c h
tên	t ê n
tênh	t ê n h
tép	t é p
tết	t ế t
tẹt	t ẹ t
tha	t h a
thá	t h á
thà	t h à
thả	t h ả
thác	t h á c
thắc	t h ắ c
thạc	t h ạ c
thách	t h á c h
thạch	t h ạ c h
thai	t h a i
thaị	t h a ị
thái	t h á i
tham	t h a m
thám	t h á m
thăm	t h ă m
thắm	t h ắ m
thẳm	t h ẳ m
thâm	t h â m
thấm	t h ấ m
thầm	t h ầ m
thẫm	t h ẫ m
thẩm	t h ẩ m
thậm	t h ậ m
thảm	t h ả m
than	t h a n
thán	t h á n
thân	t h â n
thần	t h ầ n
thẫn	t h ẫ n
thẩn	t h ẩ n
thận	t h ậ n
thản	t h ả n
thang	t h a n g
tháng	t h á n g
thăng	t h ă n g
thắng	t h ắ n g
thằng	t h ằ n g
thẳng	t h ẳ n g
thặng	t h ặ n g
thảng	t h ả n g
thanh	t h a n h
thánh	t h á n h
thành	t h à n h
thạnh	t h ạ n h
thao	t h a o
tháo	t h á o
thào	t h à o
thảo	t h ả o
thạo	t h ạ o
tháp	t h á p
thắp	t h ắ p
thấp	t h ấ p
thập	t h ậ p
thắt	t h ắ t
thất	t h ấ t
thật	t h ậ t
thâu	t h â u
thấu	t h ấ u
thay	t h a y
thây	t h â y
thấy	t h ấ y
thầy	t h ầ y
thẩy	t h ẩ y
thấỵ	t h ấ ỵ
thầỵ	t h ầ ỵ
thảy	t h ả y
the	t h e
thé	t h é
thê	t h ê
thế	t h ế
thề	t h ề
thể	t h ể
thẻ	t h ẻ
thẹ	t h ẹ
thèm	t h è m
thêm	t h ê m
thẹn	t h ẹ n
theo	t h e o
theọ	t h e ọ
thép	t h é p
thếp	t h ế p
thét	t h é t
thết	t h ế t
thêu	t h ê u
thi	t h i
thí	t h í
thì	t h ì
thỉ	t h ỉ
thị	t h ị
thía	t h í a
thích	t h í c h
thiểm	t h i ể m
thiên	t h i ê n
thiền	t h i ề n
thiển	t h i ể n
thiện	t h i ệ n
thiêng	t h i ê n g
thiếp	t h i ế p
thiệp	t h i ệ p
thiết	t h i ế t
thiệt	t h i ệ t
thiêu	t h i ê u
thiếu	t h i ế u
thiểu	t h i ể u
thiệu	t h i ệ u
thin	t h i n
thín	t h í n
thìn	t h ì n
thinh	t h i n h
thính	t h í n h
thình	t h ì n h
thỉnh	t h ỉ n h
thịnh	t h ị n h
thít	t h í t
thịt	t h ị t
thiu	t h i u
thỉu	t h ỉ u
tho	t h o
thó	t h ó
thò	t h ò
thô	t h ô
thố	t h ố
thổ	t h ổ
thỏ	t h ỏ
thọ	t h ọ
thơ	t h ơ
thờ	t h ờ
thở	t h ở
thợ	t h ợ
thoa	t h o a
thoả	t h o ả
thoái	t h o á i
thoải	t h o ả i
thoại	t h o ạ i
thoạị	t h o ạ ị
thoăn	t h o ă n
thoáng	t h o á n g
thoảng	t h o ả n g
thoát	t h o á t
thoắt	t h o ắ t
thoạt	t h o ạ t
thóc	t h ó c
thốc	t h ố c
thọc	t h ọ c
thoi	t h o i
thói	t h ó i
thòi	t h ò i
thôi	t h ô i
thối	t h ố i
thổi	t h ổ i
thội	t h ộ i
thôị	t h ô ị
thơi	t h ơ i
thới	t h ớ i
thời	t h ờ i
thôiem	t h ô i e m
thỏm	t h ỏ m
thơm	t h ơ m
thomas	t h o m a s
thon	t h o n
thôn	t h ô n
thốn	t h ố n
thộn	t h ộ n
thòng	t h ò n g
thông	t h ô n g
thống	t h ố n g
thóp	t h ó p
thót	t h ó t
thốt	t h ố t
thọt	t h ọ t
thớt	t h ớ t
thotó	t h o t ó
thpt	t h p t
throttle	t h r o t t l e
thu	t h u
thú	t h ú
thù	t h ù
thủ	t h ủ
thụ	t h ụ
thư	t h ư
thứ	t h ứ
thử	t h ử
thự	t h ự
thua	t h u a
thuạ	t h u ạ
thưa	t h ư a
thừa	t h ừ a
thuấn	t h u ấ n
thuần	t h u ầ n
thuẫn	t h u ẫ n
thuận	t h u ậ n
thuật	t h u ậ t
thuathằng	t h u a t h ằ n g
thúc	t h ú c
thục	t h ụ c
thức	t h ứ c
thực	t h ự c
thuê	t h u ê
thui	t h u i
thúi	t h ú i
thủi	t h ủ i
thung	t h u n g
thùng	t h ù n g
thủng	t h ủ n g
thừng	t h ừ n g
thuở	t h u ở
thưở	t h ư ở
thuốc	t h u ố c
thuộc	t h u ộ c
thước	t h ư ớ c
thương	t h ư ơ n g
thường	t h ư ờ n g
thưởng	t h ư ở n g
thượng	t h ư ợ n g
thướt	t h ư ớ t
thụp	t h ụ p
thưsau	t h ư s a u
thút	t h ú t
thuý	t h u ý
thuỳ	t h u ỳ
thuỷ	t h u ỷ
thuỵ	t h u ỵ
thuyền	t h u y ề n
thuyết	t h u y ế t
thy	t h y
ti	t i
tí	t í
tỉ	t ỉ
tị	t ị
tia	t i a
tía	t í a
tích	t í c h
tịch	t ị c h
tiếc	t i ế c
tiệc	t i ệ c
tiêm	t i ê m
tiềm	t i ề m
tiệm	t i ệ m
tiên	t i ê n
tiến	t i ế n
tiền	t i ề n
tiễn	t i ễ n
tiện	t i ệ n
tiếng	t i ế n g
tiếp	t i ế p
tiết	t i ế t
tiệt	t i ệ t
tiêu	t i ê u
tiếu	t i ế u
tiều	t i ề u
tiễu	t i ễ u
tiểu	t i ể u
tim	t i m
tím	t í m
tìm	t ì m
tỉm	t ỉ m
tin	t i n
tín	t í n
tinh	t i n h
tính	t í n h
tình	t ì n h
tĩnh	t ĩ n h
tỉnh	t ỉ n h
tịnh	t ị n h
típ	t í p
tipping	t i p p i n g
tít	t í t
to	t o
tò	t ò
tô	t ô
tố	t ố
tổ	t ổ
tỏ	t ỏ
tơ	t ơ
tớ	t ớ
tờ	t ờ
toà	t o à
toả	t o ả
toạ	t o ạ
tọạ	t ọ ạ
toạc	t o ạ c
toái	t o á i
toại	t o ạ i
toan	t o a n
toán	t o á n
toàn	t o à n
toang	t o a n g
toáng	t o á n g
toát	t o á t
tóc	t ó c
tốc	t ố c
tộc	t ộ c
toé	t o é
toẹt	t o ẹ t
toi	t o i
tôi	t ô i
tối	t ố i
tồi	t ồ i
tội	t ộ i
tôị	t ô ị
tộị	t ộ ị
tỏi	t ỏ i
tơi	t ơ i
tới	t ớ i
tớị	t ớ ị
tôibọn	t ô i b ọ n
tôiem	t ô i e m
tóm	t ó m
tôm	t ô m
tởm	t ở m
tomate	t o m a t e
tôn	t ô n
tốn	t ố n
tồn	t ồ n
tổn	t ổ n
tợn	t ợ n
tòng	t ò n g
tông	t ô n g
tống	t ố n g
tổng	t ổ n g
top	t o p
tốp	t ố p
tot	t o t
tót	t ó t
tốt	t ố t
tột	t ộ t
tour	t o u r
tp	t p
tphcm	t p h c m
tra	t r a
trá	t r á
trà	t r à
trả	t r ả
trác	t r á c
trắc	t r ắ c
trạc	t r ạ c
trách	t r á c h
trai	t r a i
traị	t r a ị
trái	t r á i
tráị	t r á ị
trải	t r ả i
trại	t r ạ i
trạị	t r ạ ị
tràm	t r à m
trăm	t r ă m
trâm	t r â m
trầm	t r ầ m
trảm	t r ả m
trạm	t r ạ m
trán	t r á n
tràn	t r à n
trăn	t r ă n
trân	t r â n
trấn	t r ấ n
trần	t r ầ n
trận	t r ậ n
trản	t r ả n
trang	t r a n g
tráng	t r á n g
tràng	t r à n g
trăng	t r ă n g
trắng	t r ắ n g
trạng	t r ạ n g
tranh	t r a n h
tránh	t r á n h
trành	t r à n h
trao	t r a o
trào	t r à o
trảo	t r ả o
trập	t r ậ p
trật	t r ậ t
trau	t r a u
trâu	t r â u
trầu	t r ầ u
travel	t r a v e l
traveling	t r a v e l i n g
trầy	t r ầ y
tre	t r e
trê	t r ê
trễ	t r ễ
trể	t r ể
trệ	t r ệ
trẻ	t r ẻ
trẻba	t r ẻ b a
trekking	t r e k k i n g
trên	t r ê n
treo	t r e o
trèo	t r è o
trẻo	t r ẻ o
trẹo	t r ẹ o
trêu	t r ê u
trêи	t r ê
tri	t r i
trí	t r í
trì	t r ì
trĩ	t r ĩ
trị	t r ị
trích	t r í c h
trịch	t r ị c h
triền	t r i ề n
triển	t r i ể n
triết	t r i ế t
triệt	t r i ệ t
triều	t r i ề u
triệu	t r i ệ u
triềụ	t r i ề ụ
trinh	t r i n h
trình	t r ì n h
trịnh	t r ị n h
trìu	t r ì u
tro	t r o
trò	t r ò
trố	t r ố
trổ	t r ổ
trỏ	t r ỏ
trọ	t r ọ
trơ	t r ơ
trớ	t r ớ
trờ	t r ờ
trở	t r ở
trợ	t r ợ
tróc	t r ó c
trọc	t r ọ c
trói	t r ó i
tróị	t r ó ị
trôi	t r ô i
trỗi	t r ỗ i
trội	t r ộ i
trọi	t r ọ i
trời	t r ờ i
trờị	t r ờ ị
trộm	t r ộ m
tròn	t r ò n
trốn	t r ố n
trộn	t r ộ n
trọn	t r ọ n
trơn	t r ơ n
trớn	t r ớ n
trợn	t r ợ n
trong	t r o n g
tróng	t r ó n g
tròng	t r ò n g
trông	t r ô n g
trống	t r ố n g
trồng	t r ồ n g
trọng	t r ọ n g
trongthanh	t r o n g t h a n h
trót	t r ó t
trọt	t r ọ t
tru	t r u
trú	t r ú
trụ	t r ụ
trừ	t r ừ
trữ	t r ữ
trưa	t r ư a
trúc	t r ú c
trục	t r ụ c
trực	t r ự c
trụi	t r ụ i
trùm	t r ù m
trump	t r u m p
trung	t r u n g
trúng	t r ú n g
trùng	t r ù n g
trưng	t r ư n g
trứng	t r ứ n g
trừng	t r ừ n g
trước	t r ư ớ c
trườn	t r ư ờ n
trương	t r ư ơ n g
trướng	t r ư ớ n g
trường	t r ư ờ n g
trưởng	t r ư ở n g
trượng	t r ư ợ n g
trượt	t r ư ợ t
trút	t r ú t
truy	t r u y
truỵ	t r u ỵ
truyền	t r u y ề n
truyện	t r u y ệ n
tu	t u
tú	t ú
tù	t ù
tủ	t ủ
tụ	t ụ
tư	t ư
tứ	t ứ
từ	t ừ
tử	t ử
tự	t ự
tua	t u a
túa	t ú a
tủa	t ủ a
từa	t ừ a
tựa	t ự a
tuân	t u â n
tuấn	t u ấ n
tuần	t u ầ n
tuất	t u ấ t
túc	t ú c
tục	t ụ c
tức	t ứ c
tuệ	t u ệ
tuếch	t u ế c h
tui	t u i
túi	t ú i
túị	t ú ị
tủi	t ủ i
tụi	t ụ i
tửi	t ử i
túm	t ú m
tùm	t ù m
tủm	t ủ m
tung	t u n g
túng	t ú n g
tùng	t ù n g
tủng	t ủ n g
tụng	t ụ n g
tưng	t ư n g
từng	t ừ n g
tuốc	t u ố c
tước	t ư ớ c
tuổi	t u ổ i
tuổị	t u ổ ị
tươi	t ư ơ i
tươị	t ư ơ ị
tươm	t ư ơ m
tuôn	t u ô n
tuông	t u ô n g
tương	t ư ơ n g
tướng	t ư ớ n g
tường	t ư ờ n g
tưởng	t ư ở n g
tượng	t ư ợ n g
tuột	t u ộ t
tướt	t ư ớ t
túp	t ú p
tút	t ú t
tụt	t ụ t
tửu	t ử u
tựu	t ự u
tuy	t u y
tuý	t u ý
tuỳ	t u ỳ
tuỷ	t u ỷ
tuỵ	t u ỵ
tuyên	t u y ê n
tuyến	t u y ế n
tuyền	t u y ề n
tuyển	t u y ể n
tuyết	t u y ế t
tuyệt	t u y ệ t
tvb	t v b
ty	t y
tý	t ý
tỳ	t ỳ
tỷ	t ỷ
tỵ	t ỵ
tym	t y m
u	u
ú	ú
ù	ù
ủ	ủ
ư	ư
ứ	ứ
ừ	ừ
ua	u a
úa	ú a
ùa	ù a
ủa	ủ a
ưa	ư a
uẩn	u ẩ n
uất	u ấ t
ubnd	u b n d
úc	ú c
ức	ứ c
ực	ự c
uế	u ế
ui	u i
ủi	ủ i
ukraine	u k r a i n e
ulsan	u l s a n
um	u m
ùm	ù m
ừm	ừ m
ùn	ù n
ung	u n g
úng	ú n g
ủng	ủ n g
ưng	ư n g
ứng	ứ n g
unmanned	u n m a n n e d
ước	ư ớ c
ười	ư ờ i
ươm	ư ơ m
uốn	u ố n
uống	u ố n g
uổng	u ổ n g
ương	ư ơ n g
ướt	ư ớ t
update	u p d a t e
upper	u p p e r
usd	u s d
út	ú t
utica	u t i c a
ưu	ư u
uy	u y
uý	u ý
uỷ	u ỷ
úỵ	ú ỵ
uyên	u y ê n
uyển	u y ể n
v	v
va	v a
vá	v á
và	v à
vã	v ã
vả	v ả
vạ	v ạ
vác	v á c
vắc	v ắ c
vặc	v ặ c
vạc	v ạ c
vaccine	v a c c i n e
vách	v á c h
vạch	v ạ c h
vai	v a i
vái	v á i
vài	v à i
vãi	v ã i
vải	v ả i
vại	v ạ i
vạm	v ạ m
van	v a n
ván	v á n
vàn	v à n
văn	v ă n
vắn	v ắ n
vặn	v ặ n
vân	v â n
vấn	v ấ n
vẫn	v ẫ n
vẩn	v ẩ n
vận	v ậ n
vãn	v ã n
vạn	v ạ n
vander	v a n d e r
vang	v a n g
váng	v á n g
vàng	v à n g
văng	v ă n g
vắng	v ắ n g
vằng	v ằ n g
vẳng	v ẳ n g
vâng	v â n g
vầng	v ầ n g
vãng	v ã n g
vành	v à n h
vạnh	v ạ n h
váo	v á o
vào	v à o
vàọ	v à ọ
vàokiều	v à o k i ề u
vấp	v ấ p
vập	v ậ p
vắt	v ắ t
vặt	v ặ t
vất	v ấ t
vật	v ậ t
vạt	v ạ t
vâth	v â t h
vay	v a y
váy	v á y
vây	v â y
vầy	v ầ y
vẫy	v ẫ y
vẩy	v ẩ y
vậy	v ậ y
vậỷ	v ậ ỷ
vậỵ	v ậ ỵ
ve	v e
vé	v é
vế	v ế
về	v ề
vệ	v ệ
vẽ	v ẽ
vẻ	v ẻ
ven	v e n
vén	v é n
vẹn	v ẹ n
veneer	v e n e e r
vênh	v ê n h
vểnh	v ể n h
veo	v e o
véo	v é o
vèo	v è o
vẻo	v ẻ o
ver	v e r
verkhojansk	v e r k h o a n s k
veron	v e r o n
vest	v e s t
vét	v é t
vết	v ế t
vệt	v ệ t
vgp	v g p
vi	v i
ví	v í
vì	v ì
vĩ	v ĩ
vị	v ị
vía	v í a
víạ	v í ạ
vỉa	v ỉ a
victroceramic	v i c t r o c e r a m i c
video	v i d e o
việc	v i ệ c
viêm	v i ê m
viên	v i ê n
viền	v i ề n
viễn	v i ễ n
viện	v i ệ n
viếng	v i ế n g
viết	v i ế t
việt	v i ệ t
vin	v i n
vịn	v ị n
vinh	v i n h
vĩnh	v ĩ n h
vịnh	v ị n h
vip	v i p
vipul	v i p u l
vít	v í t
vịt	v ị t
vkook	v k o o k
vl	v l
vnexpress	v n e x p r e s s
vo	v o
vó	v ó
vò	v ò
vô	v ô
vỗ	v ỗ
võ	v õ
vỏ	v ỏ
vơ	v ơ
vớ	v ớ
vờ	v ờ
vỡ	v ỡ
vở	v ở
vợ	v ợ
vóc	v ó c
vốc	v ố c
voi	v o i
vòi	v ò i
vội	v ộ i
vỏi	v ỏ i
vọi	v ọ i
vơi	v ơ i
với	v ớ i
vời	v ờ i
vớị	v ớ ị
von	v o n
vốn	v ố n
vỏn	v ỏ n
vờn	v ờ n
vong	v o n g
vòng	v ò n g
vồng	v ồ n g
võng	v õ n g
vọng	v ọ n g
vọt	v ọ t
vớt	v ớ t
vs	v s
vscn	v s c n
vu	v u
vú	v ú
vù	v ù
vũ	v ũ
vụ	v ụ
vua	v u a
vừa	v ừ a
vực	v ự c
vui	v u i
vuị	v u ị
vùi	v ù i
vun	v u n
vùn	v ù n
vụn	v ụ n
vung	v u n g
vùng	v ù n g
vụng	v ụ n g
vừng	v ừ n g
vững	v ữ n g
vươn	v ư ơ n
vườn	v ư ờ n
vượn	v ư ợ n
vuông	v u ô n g
vương	v ư ơ n g
vướng	v ư ớ n g
vuốt	v u ố t
vượt	v ư ợ t
vút	v ú t
vụt	v ụ t
vứt	v ứ t
vútttttttttttt	v ú t t t t t t t t t t t t
vưu	v ư u
vưụ	v ư ụ
vy	v y
vỹ	v ỹ
walter	a l t e r
wares	a r e s
warm	a r m
washington	a s h i n g t o n
watt	a t t
wave	a v e
wc	c
west	e s t
whitey	h i t e y
wmo	m o
x	x
xa	x a
xá	x á
xà	x à
xã	x ã
xả	x ả
xạ	x ạ
xác	x á c
xấc	x ấ c
xạc	x ạ c
xách	x á c h
xài	x à i
xám	x á m
xăm	x ă m
xâm	x â m
xẩm	x ẩ m
xán	x á n
xăn	x ă n
xắn	x ắ n
xăng	x ă n g
xanh	x a n h
xao	x a o
xaọ	x a ọ
xáo	x á o
xào	x à o
xảo	x ả o
xáp	x á p
xát	x á t
xâu	x â u
xấu	x ấ u
xầu	x ầ u
xấụ	x ấ ụ
xây	x â y
xảy	x ả y
xe	x e
xé	x é
xè	x è
xê	x ê
xế	x ế
xẻ	x ẻ
xếch	x ế c h
xem	x e m
xém	x é m
xen	x e n
xẻng	x ẻ n g
xếp	x ế p
xẹp	x ẹ p
xét	x é t
xẹt	x ẹ t
xí	x í
xì	x ì
xỉ	x ỉ
xị	x ị
xích	x í c h
xiêm	x i ê m
xiên	x i ê n
xiết	x i ế t
xin	x i n
xịn	x ị n
xinh	x i n h
xíu	x í u
xỉu	x ỉ u
xỉụ	x ỉ ụ
xó	x ó
xò	x ò
xô	x ô
xổ	x ổ
xỏ	x ỏ
xơ	x ơ
xoa	x o a
xoá	x o á
xoà	x o à
xoã	x o ã
xóạ	x ó ạ
xoạch	x o ạ c h
xoài	x o à i
xoan	x o a n
xoăn	x o ă n
xoắn	x o ắ n
xoang	x o a n g
xoảng	x o ả n g
xoay	x o a y
xoáy	x o á y
xóc	x ó c
xốc	x ố c
xộc	x ộ c
xoe	x o e
xoè	x o è
xoẹt	x o ẹ t
xói	x ó i
xôi	x ô i
xối	x ố i
xơi	x ơ i
xóm	x ó m
xổm	x ổ m
xôn	x ô n
xộn	x ộ n
xong	x o n g
xông	x ô n g
xốp	x ố p
xót	x ó t
xu	x u
xù	x ù
xứ	x ứ
xử	x ử
xua	x u a
xưa	x ư a
xửa	x ử a
xưạ	x ư ạ
xuân	x u â n
xuẩn	x u ẩ n
xuanle	x u a n l e
xuát	x u á t
xuất	x u ấ t
xúc	x ú c
xuê	x u ê
xuề	x u ề
xuể	x u ể
xui	x u i
xum	x u m
xúm	x ú m
xung	x u n g
xưng	x ư n g
xứng	x ứ n g
xước	x ư ớ c
xược	x ư ợ c
xuôi	x u ô i
xuống	x u ố n g
xuồng	x u ồ n g
xương	x ư ơ n g
xưởng	x ư ở n g
xuyên	x u y ê n
xuyến	x u y ế n
xyz	x y z
y	y
ý	ý
ỹ	ỹ
ỷ	ỷ
ỵ	ỵ
yakutia	y a k u t i a
yếm	y ế m
yểm	y ể m
yên	y ê n
yến	y ế n
yết	y ế t
yêu	y ê u
yếu	y ế u
yểu	y ể u
yểụ	y ể ụ
york	y o r k
youtube	y o u t u b e
zai	z a i
zái	z á i
zalo	z a l o
